air_store_id,hpg_store_id,visit_date,reserve_visitors_air,reserve_visitors_hpg,visitors,reserve_visitors
air_3e93f3c81008696d,hpg_c2a8494d55fafbd6,2016-10-27,12,2,48,14
air_3e93f3c81008696d,hpg_c2a8494d55fafbd6,2016-10-28,4,2,25,6
air_3e93f3c81008696d,hpg_c2a8494d55fafbd6,2016-10-29,17,28,42,45
air_3e93f3c81008696d,hpg_c2a8494d55fafbd6,2016-11-01,74,3,76,77
air_3e93f3c81008696d,hpg_c2a8494d55fafbd6,2016-11-04,11,7,5,18
air_3e93f3c81008696d,hpg_c2a8494d55fafbd6,2016-11-05,26,12,51,38
air_3e93f3c81008696d,hpg_c2a8494d55fafbd6,2016-11-07,2,2,9,4
air_3e93f3c81008696d,hpg_c2a8494d55fafbd6,2016-11-19,13,9,66,22
air_3e93f3c81008696d,hpg_c2a8494d55fafbd6,2016-11-22,13,4,7,17
air_3e93f3c81008696d,hpg_c2a8494d55fafbd6,2016-11-23,15,2,36,17
air_3e93f3c81008696d,hpg_c2a8494d55fafbd6,2016-11-24,10,2,25,12
air_3e93f3c81008696d,hpg_c2a8494d55fafbd6,2016-11-25,15,4,19,19
air_3e93f3c81008696d,hpg_c2a8494d55fafbd6,2016-11-28,4,2,17,6
air_3e93f3c81008696d,hpg_c2a8494d55fafbd6,2016-11-29,12,7,17,19
air_3e93f3c81008696d,hpg_c2a8494d55fafbd6,2016-12-02,14,8,8,22
air_3e93f3c81008696d,hpg_c2a8494d55fafbd6,2016-12-09,39,9,39,48
air_3e93f3c81008696d,hpg_c2a8494d55fafbd6,2016-12-10,13,8,51,21
air_3e93f3c81008696d,hpg_c2a8494d55fafbd6,2016-12-12,4,2,23,6
air_3e93f3c81008696d,hpg_c2a8494d55fafbd6,2016-12-13,7,3,23,10
air_3e93f3c81008696d,hpg_c2a8494d55fafbd6,2016-12-16,19,20,18,39
air_3e93f3c81008696d,hpg_c2a8494d55fafbd6,2016-12-17,22,23,56,45
air_3e93f3c81008696d,hpg_c2a8494d55fafbd6,2016-12-19,20,2,9,22
air_3e93f3c81008696d,hpg_c2a8494d55fafbd6,2016-12-22,45,19,70,64
air_3e93f3c81008696d,hpg_c2a8494d55fafbd6,2016-12-23,58,2,18,60
air_3e93f3c81008696d,hpg_c2a8494d55fafbd6,2016-12-24,20,10,24,30
air_3e93f3c81008696d,hpg_c2a8494d55fafbd6,2016-12-26,20,2,37,22
air_3e93f3c81008696d,hpg_c2a8494d55fafbd6,2016-12-27,25,5,14,30
air_3e93f3c81008696d,hpg_c2a8494d55fafbd6,2016-12-28,26,2,67,28
air_3e93f3c81008696d,hpg_c2a8494d55fafbd6,2016-12-29,24,5,30,29
air_3e93f3c81008696d,hpg_c2a8494d55fafbd6,2016-12-30,24,5,27,29
air_3e93f3c81008696d,hpg_c2a8494d55fafbd6,2017-01-06,21,17,21,38
air_3e93f3c81008696d,hpg_c2a8494d55fafbd6,2017-01-07,8,4,41,12
air_3e93f3c81008696d,hpg_c2a8494d55fafbd6,2017-01-08,18,2,27,20
air_3e93f3c81008696d,hpg_c2a8494d55fafbd6,2017-01-10,2,2,9,4
air_3e93f3c81008696d,hpg_c2a8494d55fafbd6,2017-01-11,4,2,8,6
air_3e93f3c81008696d,hpg_c2a8494d55fafbd6,2017-01-14,18,4,21,22
air_3e93f3c81008696d,hpg_c2a8494d55fafbd6,2017-01-21,29,10,46,39
air_3e93f3c81008696d,hpg_c2a8494d55fafbd6,2017-01-23,20,14,2,34
air_3e93f3c81008696d,hpg_c2a8494d55fafbd6,2017-01-25,25,2,10,27
air_3e93f3c81008696d,hpg_c2a8494d55fafbd6,2017-01-26,16,6,3,22
air_3e93f3c81008696d,hpg_c2a8494d55fafbd6,2017-01-27,27,8,48,35
air_3e93f3c81008696d,hpg_c2a8494d55fafbd6,2017-01-28,37,13,39,50
air_3e93f3c81008696d,hpg_c2a8494d55fafbd6,2017-02-01,9,5,14,14
air_3e93f3c81008696d,hpg_c2a8494d55fafbd6,2017-02-03,32,20,51,52
air_3e93f3c81008696d,hpg_c2a8494d55fafbd6,2017-02-04,35,8,20,43
air_3e93f3c81008696d,hpg_c2a8494d55fafbd6,2017-02-06,4,4,46,8
air_3e93f3c81008696d,hpg_c2a8494d55fafbd6,2017-02-09,28,4,36,32
air_3e93f3c81008696d,hpg_c2a8494d55fafbd6,2017-02-10,19,14,50,33
air_3e93f3c81008696d,hpg_c2a8494d55fafbd6,2017-02-11,28,4,46,32
air_3e93f3c81008696d,hpg_c2a8494d55fafbd6,2017-02-15,9,2,44,11
air_3e93f3c81008696d,hpg_c2a8494d55fafbd6,2017-02-17,22,3,17,25
air_3e93f3c81008696d,hpg_c2a8494d55fafbd6,2017-02-18,19,12,64,31
air_3e93f3c81008696d,hpg_c2a8494d55fafbd6,2017-02-22,11,9,25,20
air_3e93f3c81008696d,hpg_c2a8494d55fafbd6,2017-02-23,20,11,27,31
air_3e93f3c81008696d,hpg_c2a8494d55fafbd6,2017-02-25,33,13,47,46
air_3e93f3c81008696d,hpg_c2a8494d55fafbd6,2017-02-27,9,5,3,14
air_3e93f3c81008696d,hpg_c2a8494d55fafbd6,2017-03-01,15,7,21,22
air_3e93f3c81008696d,hpg_c2a8494d55fafbd6,2017-03-02,16,4,74,20
air_3e93f3c81008696d,hpg_c2a8494d55fafbd6,2017-03-03,17,12,11,29
air_3e93f3c81008696d,hpg_c2a8494d55fafbd6,2017-03-04,44,7,93,51
air_3e93f3c81008696d,hpg_c2a8494d55fafbd6,2017-03-08,8,6,51,14
air_3e93f3c81008696d,hpg_c2a8494d55fafbd6,2017-03-09,27,5,39,32
air_3e93f3c81008696d,hpg_c2a8494d55fafbd6,2017-03-10,33,6,38,39
air_3e93f3c81008696d,hpg_c2a8494d55fafbd6,2017-03-11,21,2,16,23
air_3e93f3c81008696d,hpg_c2a8494d55fafbd6,2017-03-13,26,26,90,52
air_3e93f3c81008696d,hpg_c2a8494d55fafbd6,2017-03-14,18,14,20,32
air_3e93f3c81008696d,hpg_c2a8494d55fafbd6,2017-03-16,16,3,68,19
air_3e93f3c81008696d,hpg_c2a8494d55fafbd6,2017-03-17,21,2,23,23
air_3e93f3c81008696d,hpg_c2a8494d55fafbd6,2017-03-18,6,2,67,8
air_3e93f3c81008696d,hpg_c2a8494d55fafbd6,2017-03-19,28,2,60,30
air_3e93f3c81008696d,hpg_c2a8494d55fafbd6,2017-03-22,11,2,18,13
air_3e93f3c81008696d,hpg_c2a8494d55fafbd6,2017-03-23,27,6,68,33
air_3e93f3c81008696d,hpg_c2a8494d55fafbd6,2017-03-24,21,9,42,30
air_3e93f3c81008696d,hpg_c2a8494d55fafbd6,2017-03-28,13,10,45,23
air_3e93f3c81008696d,hpg_c2a8494d55fafbd6,2017-03-30,24,10,12,34
air_3e93f3c81008696d,hpg_c2a8494d55fafbd6,2017-03-31,40,11,60,51
air_3e93f3c81008696d,hpg_c2a8494d55fafbd6,2017-04-01,17,10,90,27
air_3e93f3c81008696d,hpg_c2a8494d55fafbd6,2017-04-03,8,8,12,16
air_3e93f3c81008696d,hpg_c2a8494d55fafbd6,2017-04-06,10,2,17,12
air_3e93f3c81008696d,hpg_c2a8494d55fafbd6,2017-04-07,22,7,24,29
air_3e93f3c81008696d,hpg_c2a8494d55fafbd6,2017-04-08,20,7,34,27
air_3e93f3c81008696d,hpg_c2a8494d55fafbd6,2017-04-11,9,6,22,15
air_3e93f3c81008696d,hpg_c2a8494d55fafbd6,2017-04-12,31,7,33,38
air_3e93f3c81008696d,hpg_c2a8494d55fafbd6,2017-04-14,29,12,42,41
air_3e93f3c81008696d,hpg_c2a8494d55fafbd6,2017-04-15,23,8,66,31
air_3e93f3c81008696d,hpg_c2a8494d55fafbd6,2017-04-18,16,9,46,25
air_3e93f3c81008696d,hpg_c2a8494d55fafbd6,2017-04-21,45,8,47,53
air_3e93f3c81008696d,hpg_c2a8494d55fafbd6,2017-04-22,25,2,52,27
air_37189c92b6c761ec,hpg_2e10e1956528199a,2016-02-08,2,7,6,9
air_37189c92b6c761ec,hpg_2e10e1956528199a,2016-03-12,3,3,30,6
air_37189c92b6c761ec,hpg_2e10e1956528199a,2016-03-14,2,4,8,6
air_37189c92b6c761ec,hpg_2e10e1956528199a,2016-03-21,2,2,4,4
air_37189c92b6c761ec,hpg_2e10e1956528199a,2016-03-24,10,10,24,20
air_37189c92b6c761ec,hpg_2e10e1956528199a,2016-03-28,2,2,5,4
air_37189c92b6c761ec,hpg_2e10e1956528199a,2016-03-30,9,9,14,18
air_37189c92b6c761ec,hpg_2e10e1956528199a,2016-04-02,13,13,39,26
air_37189c92b6c761ec,hpg_2e10e1956528199a,2016-04-08,7,23,13,30
air_37189c92b6c761ec,hpg_2e10e1956528199a,2016-04-12,6,6,8,12
air_37189c92b6c761ec,hpg_2e10e1956528199a,2016-04-22,4,8,10,12
air_37189c92b6c761ec,hpg_2e10e1956528199a,2016-04-24,4,4,44,8
air_37189c92b6c761ec,hpg_2e10e1956528199a,2016-04-27,3,3,15,6
air_37189c92b6c761ec,hpg_2e10e1956528199a,2016-04-29,4,4,30,8
air_37189c92b6c761ec,hpg_2e10e1956528199a,2016-04-30,8,8,21,16
air_37189c92b6c761ec,hpg_2e10e1956528199a,2016-05-01,2,4,13,6
air_37189c92b6c761ec,hpg_2e10e1956528199a,2016-05-04,2,2,27,4
air_37189c92b6c761ec,hpg_2e10e1956528199a,2016-05-07,2,2,17,4
air_37189c92b6c761ec,hpg_2e10e1956528199a,2016-05-09,5,5,11,10
air_37189c92b6c761ec,hpg_2e10e1956528199a,2016-05-21,2,2,19,4
air_37189c92b6c761ec,hpg_2e10e1956528199a,2016-05-28,2,9,57,11
air_37189c92b6c761ec,hpg_2e10e1956528199a,2016-06-03,4,4,20,8
air_37189c92b6c761ec,hpg_2e10e1956528199a,2016-06-04,4,4,29,8
air_37189c92b6c761ec,hpg_2e10e1956528199a,2016-06-10,11,15,27,26
air_37189c92b6c761ec,hpg_2e10e1956528199a,2016-06-16,2,2,5,4
air_37189c92b6c761ec,hpg_2e10e1956528199a,2016-06-17,4,4,14,8
air_37189c92b6c761ec,hpg_2e10e1956528199a,2016-06-18,6,12,17,18
air_37189c92b6c761ec,hpg_2e10e1956528199a,2016-06-25,8,6,33,14
air_37189c92b6c761ec,hpg_2e10e1956528199a,2016-07-02,2,6,18,8
air_37189c92b6c761ec,hpg_2e10e1956528199a,2016-07-07,3,3,5,6
air_37189c92b6c761ec,hpg_2e10e1956528199a,2016-07-10,4,14,46,18
air_37189c92b6c761ec,hpg_2e10e1956528199a,2016-07-15,2,2,18,4
air_37189c92b6c761ec,hpg_2e10e1956528199a,2016-07-16,2,5,20,7
air_37189c92b6c761ec,hpg_2e10e1956528199a,2016-07-25,2,2,5,4
air_37189c92b6c761ec,hpg_2e10e1956528199a,2016-10-28,10,10,34,20
air_37189c92b6c761ec,hpg_2e10e1956528199a,2016-10-30,4,4,33,8
air_37189c92b6c761ec,hpg_2e10e1956528199a,2016-10-31,3,3,11,6
air_37189c92b6c761ec,hpg_2e10e1956528199a,2016-11-05,6,6,11,12
air_37189c92b6c761ec,hpg_2e10e1956528199a,2016-11-10,4,4,8,8
air_37189c92b6c761ec,hpg_2e10e1956528199a,2016-11-11,8,8,4,16
air_37189c92b6c761ec,hpg_2e10e1956528199a,2016-11-21,2,2,8,4
air_37189c92b6c761ec,hpg_2e10e1956528199a,2016-11-25,5,7,5,12
air_37189c92b6c761ec,hpg_2e10e1956528199a,2016-12-14,3,3,9,6
air_37189c92b6c761ec,hpg_2e10e1956528199a,2016-12-15,8,23,21,31
air_37189c92b6c761ec,hpg_2e10e1956528199a,2017-01-30,2,2,11,4
air_37189c92b6c761ec,hpg_2e10e1956528199a,2017-02-15,18,53,27,71
air_37189c92b6c761ec,hpg_2e10e1956528199a,2017-03-06,2,2,58,4
air_37189c92b6c761ec,hpg_2e10e1956528199a,2017-03-13,4,4,8,8
air_37189c92b6c761ec,hpg_2e10e1956528199a,2017-04-17,2,2,3,4
air_37189c92b6c761ec,hpg_2e10e1956528199a,2017-04-18,6,10,7,16
air_37189c92b6c761ec,hpg_2e10e1956528199a,2017-04-21,18,18,2,36
air_7514d90009613cd6,hpg_08def9f764fcca4c,2016-11-09,12,7,18,19
air_7514d90009613cd6,hpg_08def9f764fcca4c,2016-12-02,47,33,98,80
air_7514d90009613cd6,hpg_08def9f764fcca4c,2016-12-03,29,21,55,50
air_7514d90009613cd6,hpg_08def9f764fcca4c,2016-12-04,88,11,207,99
air_7514d90009613cd6,hpg_08def9f764fcca4c,2016-12-10,86,27,146,113
air_7514d90009613cd6,hpg_08def9f764fcca4c,2016-12-13,8,28,23,36
air_7514d90009613cd6,hpg_08def9f764fcca4c,2016-12-17,107,157,170,264
air_7514d90009613cd6,hpg_08def9f764fcca4c,2016-12-23,20,15,129,35
air_7514d90009613cd6,hpg_08def9f764fcca4c,2016-12-26,21,17,45,38
air_7514d90009613cd6,hpg_08def9f764fcca4c,2016-12-30,32,14,104,46
air_7514d90009613cd6,hpg_08def9f764fcca4c,2017-01-04,6,6,45,12
air_7514d90009613cd6,hpg_08def9f764fcca4c,2017-01-25,26,28,26,54
air_7514d90009613cd6,hpg_08def9f764fcca4c,2017-02-14,6,6,1,12
air_7514d90009613cd6,hpg_08def9f764fcca4c,2017-03-05,37,40,87,77
air_7514d90009613cd6,hpg_08def9f764fcca4c,2017-03-12,11,11,216,22
air_7514d90009613cd6,hpg_08def9f764fcca4c,2017-03-13,16,16,40,32
air_7514d90009613cd6,hpg_08def9f764fcca4c,2017-03-14,32,60,32,92
air_7514d90009613cd6,hpg_08def9f764fcca4c,2017-03-18,69,87,122,156
air_7514d90009613cd6,hpg_08def9f764fcca4c,2017-03-27,13,13,18,26
air_7ef9a5ea5c8fe39f,hpg_8afe014b4a994a79,2016-07-08,20,2,16,22
air_7ef9a5ea5c8fe39f,hpg_8afe014b4a994a79,2016-07-09,14,4,34,18
air_7ef9a5ea5c8fe39f,hpg_8afe014b4a994a79,2016-07-10,4,2,14,6
air_7ef9a5ea5c8fe39f,hpg_8afe014b4a994a79,2016-10-28,17,4,16,21
air_7ef9a5ea5c8fe39f,hpg_8afe014b4a994a79,2016-10-30,10,2,21,12
air_7ef9a5ea5c8fe39f,hpg_8afe014b4a994a79,2016-11-04,18,3,18,21
air_7ef9a5ea5c8fe39f,hpg_8afe014b4a994a79,2016-11-12,15,5,25,20
air_7ef9a5ea5c8fe39f,hpg_8afe014b4a994a79,2016-11-13,3,3,3,6
air_7ef9a5ea5c8fe39f,hpg_8afe014b4a994a79,2016-11-14,7,2,9,9
air_7ef9a5ea5c8fe39f,hpg_8afe014b4a994a79,2016-11-17,2,2,3,4
air_7ef9a5ea5c8fe39f,hpg_8afe014b4a994a79,2016-11-19,9,2,24,11
air_7ef9a5ea5c8fe39f,hpg_8afe014b4a994a79,2016-11-22,10,4,19,14
air_7ef9a5ea5c8fe39f,hpg_8afe014b4a994a79,2016-11-25,13,3,19,16
air_7ef9a5ea5c8fe39f,hpg_8afe014b4a994a79,2016-11-26,2,2,14,4
air_7ef9a5ea5c8fe39f,hpg_8afe014b4a994a79,2016-12-03,15,9,25,24
air_7ef9a5ea5c8fe39f,hpg_8afe014b4a994a79,2016-12-08,8,3,12,11
air_7ef9a5ea5c8fe39f,hpg_8afe014b4a994a79,2016-12-09,21,4,24,25
air_7ef9a5ea5c8fe39f,hpg_8afe014b4a994a79,2016-12-14,7,2,12,9
air_7ef9a5ea5c8fe39f,hpg_8afe014b4a994a79,2016-12-16,15,4,25,19
air_7ef9a5ea5c8fe39f,hpg_8afe014b4a994a79,2016-12-17,36,27,23,63
air_7ef9a5ea5c8fe39f,hpg_8afe014b4a994a79,2016-12-18,2,2,25,4
air_7ef9a5ea5c8fe39f,hpg_8afe014b4a994a79,2016-12-23,10,4,20,14
air_7ef9a5ea5c8fe39f,hpg_8afe014b4a994a79,2016-12-24,20,18,25,38
air_7ef9a5ea5c8fe39f,hpg_8afe014b4a994a79,2016-12-25,18,6,28,24
air_7ef9a5ea5c8fe39f,hpg_8afe014b4a994a79,2016-12-26,10,6,28,16
air_7ef9a5ea5c8fe39f,hpg_8afe014b4a994a79,2016-12-27,16,5,17,21
air_7ef9a5ea5c8fe39f,hpg_8afe014b4a994a79,2016-12-28,23,7,35,30
air_7ef9a5ea5c8fe39f,hpg_8afe014b4a994a79,2016-12-30,23,18,35,41
air_7ef9a5ea5c8fe39f,hpg_8afe014b4a994a79,2017-01-05,14,5,23,19
air_7ef9a5ea5c8fe39f,hpg_8afe014b4a994a79,2017-01-06,11,2,15,13
air_7ef9a5ea5c8fe39f,hpg_8afe014b4a994a79,2017-01-07,13,3,26,16
air_7ef9a5ea5c8fe39f,hpg_8afe014b4a994a79,2017-01-08,5,3,14,8
air_7ef9a5ea5c8fe39f,hpg_8afe014b4a994a79,2017-01-17,9,4,11,13
air_7ef9a5ea5c8fe39f,hpg_8afe014b4a994a79,2017-01-20,17,4,19,21
air_7ef9a5ea5c8fe39f,hpg_8afe014b4a994a79,2017-01-22,5,3,15,8
air_7ef9a5ea5c8fe39f,hpg_8afe014b4a994a79,2017-01-25,7,7,15,14
air_7ef9a5ea5c8fe39f,hpg_8afe014b4a994a79,2017-01-28,11,4,28,15
air_7ef9a5ea5c8fe39f,hpg_8afe014b4a994a79,2017-01-29,3,3,6,6
air_7ef9a5ea5c8fe39f,hpg_8afe014b4a994a79,2017-01-30,3,3,3,6
air_7ef9a5ea5c8fe39f,hpg_8afe014b4a994a79,2017-01-31,8,3,10,11
air_7ef9a5ea5c8fe39f,hpg_8afe014b4a994a79,2017-02-07,11,7,15,18
air_7ef9a5ea5c8fe39f,hpg_8afe014b4a994a79,2017-02-10,25,4,28,29
air_7ef9a5ea5c8fe39f,hpg_8afe014b4a994a79,2017-02-14,4,4,5,8
air_7ef9a5ea5c8fe39f,hpg_8afe014b4a994a79,2017-02-15,11,4,17,15
air_7ef9a5ea5c8fe39f,hpg_8afe014b4a994a79,2017-02-16,4,6,4,10
air_7ef9a5ea5c8fe39f,hpg_8afe014b4a994a79,2017-02-17,10,7,15,17
air_7ef9a5ea5c8fe39f,hpg_8afe014b4a994a79,2017-02-18,13,4,29,17
air_7ef9a5ea5c8fe39f,hpg_8afe014b4a994a79,2017-02-19,6,6,6,12
air_7ef9a5ea5c8fe39f,hpg_8afe014b4a994a79,2017-02-21,8,4,8,12
air_7ef9a5ea5c8fe39f,hpg_8afe014b4a994a79,2017-02-23,6,2,8,8
air_7ef9a5ea5c8fe39f,hpg_8afe014b4a994a79,2017-02-24,19,7,26,26
air_7ef9a5ea5c8fe39f,hpg_8afe014b4a994a79,2017-02-25,20,6,28,26
air_7ef9a5ea5c8fe39f,hpg_8afe014b4a994a79,2017-02-26,9,4,16,13
air_7ef9a5ea5c8fe39f,hpg_8afe014b4a994a79,2017-03-02,11,6,13,17
air_7ef9a5ea5c8fe39f,hpg_8afe014b4a994a79,2017-03-04,15,4,15,19
air_7ef9a5ea5c8fe39f,hpg_8afe014b4a994a79,2017-03-07,6,2,6,8
air_7ef9a5ea5c8fe39f,hpg_8afe014b4a994a79,2017-03-10,18,7,14,25
air_7ef9a5ea5c8fe39f,hpg_8afe014b4a994a79,2017-03-12,10,4,13,14
air_7ef9a5ea5c8fe39f,hpg_8afe014b4a994a79,2017-03-13,10,5,10,15
air_7ef9a5ea5c8fe39f,hpg_8afe014b4a994a79,2017-03-19,22,5,26,27
air_7ef9a5ea5c8fe39f,hpg_8afe014b4a994a79,2017-03-20,2,2,7,4
air_7ef9a5ea5c8fe39f,hpg_8afe014b4a994a79,2017-03-22,12,7,18,19
air_7ef9a5ea5c8fe39f,hpg_8afe014b4a994a79,2017-03-23,8,6,17,14
air_7ef9a5ea5c8fe39f,hpg_8afe014b4a994a79,2017-03-25,14,2,24,16
air_7ef9a5ea5c8fe39f,hpg_8afe014b4a994a79,2017-03-29,4,2,15,6
air_7ef9a5ea5c8fe39f,hpg_8afe014b4a994a79,2017-03-30,12,6,18,18
air_7ef9a5ea5c8fe39f,hpg_8afe014b4a994a79,2017-03-31,6,2,12,8
air_7ef9a5ea5c8fe39f,hpg_8afe014b4a994a79,2017-04-04,15,13,20,28
air_7ef9a5ea5c8fe39f,hpg_8afe014b4a994a79,2017-04-05,2,2,6,4
air_7ef9a5ea5c8fe39f,hpg_8afe014b4a994a79,2017-04-07,6,2,6,8
air_7ef9a5ea5c8fe39f,hpg_8afe014b4a994a79,2017-04-09,13,2,16,15
air_7ef9a5ea5c8fe39f,hpg_8afe014b4a994a79,2017-04-15,18,9,18,27
air_7ef9a5ea5c8fe39f,hpg_8afe014b4a994a79,2017-04-17,2,2,9,4
air_7ef9a5ea5c8fe39f,hpg_8afe014b4a994a79,2017-04-19,2,2,11,4
air_7ef9a5ea5c8fe39f,hpg_8afe014b4a994a79,2017-04-21,7,5,12,12
air_7ef9a5ea5c8fe39f,hpg_8afe014b4a994a79,2017-04-22,9,3,11,12
air_831658500aa7c846,hpg_f39996d4f0ebcb64,2016-10-31,6,6,36,12
air_831658500aa7c846,hpg_f39996d4f0ebcb64,2016-11-02,4,4,40,8
air_831658500aa7c846,hpg_f39996d4f0ebcb64,2016-11-05,2,2,13,4
air_831658500aa7c846,hpg_f39996d4f0ebcb64,2016-11-12,5,5,28,10
air_831658500aa7c846,hpg_f39996d4f0ebcb64,2016-11-18,3,3,49,6
air_831658500aa7c846,hpg_f39996d4f0ebcb64,2016-11-19,13,13,25,26
air_831658500aa7c846,hpg_f39996d4f0ebcb64,2016-12-02,8,8,43,16
air_831658500aa7c846,hpg_f39996d4f0ebcb64,2016-12-06,3,3,41,6
air_831658500aa7c846,hpg_f39996d4f0ebcb64,2016-12-10,7,7,43,14
air_831658500aa7c846,hpg_f39996d4f0ebcb64,2016-12-12,4,4,16,8
air_831658500aa7c846,hpg_f39996d4f0ebcb64,2016-12-13,5,5,23,10
air_831658500aa7c846,hpg_f39996d4f0ebcb64,2016-12-14,2,2,39,4
air_831658500aa7c846,hpg_f39996d4f0ebcb64,2016-12-17,2,4,45,6
air_831658500aa7c846,hpg_f39996d4f0ebcb64,2016-12-20,3,10,42,13
air_831658500aa7c846,hpg_f39996d4f0ebcb64,2016-12-22,14,44,44,58
air_831658500aa7c846,hpg_f39996d4f0ebcb64,2016-12-24,5,2,30,7
air_831658500aa7c846,hpg_f39996d4f0ebcb64,2016-12-27,4,10,47,14
air_831658500aa7c846,hpg_f39996d4f0ebcb64,2016-12-29,4,4,48,8
air_831658500aa7c846,hpg_f39996d4f0ebcb64,2017-01-06,4,4,40,8
air_831658500aa7c846,hpg_f39996d4f0ebcb64,2017-01-07,2,2,20,4
air_831658500aa7c846,hpg_f39996d4f0ebcb64,2017-01-14,6,6,42,12
air_831658500aa7c846,hpg_f39996d4f0ebcb64,2017-01-18,12,12,44,24
air_831658500aa7c846,hpg_f39996d4f0ebcb64,2017-01-20,4,4,43,8
air_831658500aa7c846,hpg_f39996d4f0ebcb64,2017-01-21,4,4,27,8
air_831658500aa7c846,hpg_f39996d4f0ebcb64,2017-01-25,15,15,33,30
air_831658500aa7c846,hpg_f39996d4f0ebcb64,2017-01-27,6,6,53,12
air_831658500aa7c846,hpg_f39996d4f0ebcb64,2017-01-28,2,2,34,4
air_831658500aa7c846,hpg_f39996d4f0ebcb64,2017-02-08,5,5,55,10
air_831658500aa7c846,hpg_f39996d4f0ebcb64,2017-02-10,8,12,38,20
air_831658500aa7c846,hpg_f39996d4f0ebcb64,2017-02-17,16,16,41,32
air_831658500aa7c846,hpg_f39996d4f0ebcb64,2017-02-21,2,2,16,4
air_831658500aa7c846,hpg_f39996d4f0ebcb64,2017-02-22,18,34,40,52
air_831658500aa7c846,hpg_f39996d4f0ebcb64,2017-02-24,4,4,44,8
air_831658500aa7c846,hpg_f39996d4f0ebcb64,2017-02-25,5,5,34,10
air_831658500aa7c846,hpg_f39996d4f0ebcb64,2017-03-02,6,6,41,12
air_831658500aa7c846,hpg_f39996d4f0ebcb64,2017-03-10,19,21,47,40
air_831658500aa7c846,hpg_f39996d4f0ebcb64,2017-03-16,9,9,42,18
air_831658500aa7c846,hpg_f39996d4f0ebcb64,2017-03-25,2,2,42,4
air_831658500aa7c846,hpg_f39996d4f0ebcb64,2017-03-28,4,4,35,8
air_831658500aa7c846,hpg_f39996d4f0ebcb64,2017-03-31,2,9,59,11
air_831658500aa7c846,hpg_f39996d4f0ebcb64,2017-04-01,4,6,18,10
air_831658500aa7c846,hpg_f39996d4f0ebcb64,2017-04-04,4,4,18,8
air_831658500aa7c846,hpg_f39996d4f0ebcb64,2017-04-05,4,4,12,8
air_831658500aa7c846,hpg_f39996d4f0ebcb64,2017-04-07,2,5,40,7
air_831658500aa7c846,hpg_f39996d4f0ebcb64,2017-04-08,7,5,16,12
air_831658500aa7c846,hpg_f39996d4f0ebcb64,2017-04-11,5,8,22,13
air_831658500aa7c846,hpg_f39996d4f0ebcb64,2017-04-14,4,16,50,20
air_831658500aa7c846,hpg_f39996d4f0ebcb64,2017-04-15,3,3,26,6
air_831658500aa7c846,hpg_f39996d4f0ebcb64,2017-04-20,2,4,41,6
air_831658500aa7c846,hpg_f39996d4f0ebcb64,2017-04-21,3,16,50,19
air_831658500aa7c846,hpg_f39996d4f0ebcb64,2017-04-22,6,6,24,12
air_eec5e572b9eb9c23,hpg_e6594f29f40fe2aa,2016-07-01,2,2,23,4
air_eec5e572b9eb9c23,hpg_e6594f29f40fe2aa,2016-07-03,4,4,25,8
air_eec5e572b9eb9c23,hpg_e6594f29f40fe2aa,2016-07-08,8,8,11,16
air_eec5e572b9eb9c23,hpg_e6594f29f40fe2aa,2016-07-14,14,14,4,28
air_eec5e572b9eb9c23,hpg_e6594f29f40fe2aa,2016-07-15,10,4,27,14
air_eec5e572b9eb9c23,hpg_e6594f29f40fe2aa,2016-07-16,3,6,4,9
air_eec5e572b9eb9c23,hpg_e6594f29f40fe2aa,2016-07-24,10,5,10,15
air_eec5e572b9eb9c23,hpg_e6594f29f40fe2aa,2016-10-27,6,5,16,11
air_eec5e572b9eb9c23,hpg_e6594f29f40fe2aa,2016-11-04,3,3,8,6
air_eec5e572b9eb9c23,hpg_e6594f29f40fe2aa,2016-11-18,5,5,15,10
air_eec5e572b9eb9c23,hpg_e6594f29f40fe2aa,2016-11-19,2,2,20,4
air_eec5e572b9eb9c23,hpg_e6594f29f40fe2aa,2016-11-22,3,3,7,6
air_eec5e572b9eb9c23,hpg_e6594f29f40fe2aa,2016-11-23,5,5,31,10
air_eec5e572b9eb9c23,hpg_e6594f29f40fe2aa,2016-11-25,26,23,29,49
air_eec5e572b9eb9c23,hpg_e6594f29f40fe2aa,2016-11-26,22,11,34,33
air_eec5e572b9eb9c23,hpg_e6594f29f40fe2aa,2016-12-01,2,2,3,4
air_eec5e572b9eb9c23,hpg_e6594f29f40fe2aa,2016-12-03,16,16,30,32
air_eec5e572b9eb9c23,hpg_e6594f29f40fe2aa,2016-12-07,8,20,8,28
air_eec5e572b9eb9c23,hpg_e6594f29f40fe2aa,2016-12-08,2,2,10,4
air_eec5e572b9eb9c23,hpg_e6594f29f40fe2aa,2016-12-09,23,2,7,25
air_eec5e572b9eb9c23,hpg_e6594f29f40fe2aa,2016-12-10,34,41,69,75
air_eec5e572b9eb9c23,hpg_e6594f29f40fe2aa,2016-12-16,8,9,27,17
air_eec5e572b9eb9c23,hpg_e6594f29f40fe2aa,2016-12-17,47,48,50,95
air_eec5e572b9eb9c23,hpg_e6594f29f40fe2aa,2016-12-18,16,2,45,18
air_eec5e572b9eb9c23,hpg_e6594f29f40fe2aa,2016-12-23,33,29,39,62
air_eec5e572b9eb9c23,hpg_e6594f29f40fe2aa,2016-12-24,22,22,4,44
air_eec5e572b9eb9c23,hpg_e6594f29f40fe2aa,2016-12-27,27,27,52,54
air_eec5e572b9eb9c23,hpg_e6594f29f40fe2aa,2016-12-29,4,4,14,8
air_eec5e572b9eb9c23,hpg_e6594f29f40fe2aa,2016-12-31,20,20,43,40
air_eec5e572b9eb9c23,hpg_e6594f29f40fe2aa,2017-01-06,6,6,19,12
air_eec5e572b9eb9c23,hpg_e6594f29f40fe2aa,2017-01-10,2,2,2,4
air_eec5e572b9eb9c23,hpg_e6594f29f40fe2aa,2017-01-13,2,2,5,4
air_eec5e572b9eb9c23,hpg_e6594f29f40fe2aa,2017-01-14,23,7,40,30
air_eec5e572b9eb9c23,hpg_e6594f29f40fe2aa,2017-01-18,4,4,11,8
air_eec5e572b9eb9c23,hpg_e6594f29f40fe2aa,2017-01-20,2,2,9,4
air_eec5e572b9eb9c23,hpg_e6594f29f40fe2aa,2017-01-26,7,7,9,14
air_eec5e572b9eb9c23,hpg_e6594f29f40fe2aa,2017-01-28,2,2,12,4
air_eec5e572b9eb9c23,hpg_e6594f29f40fe2aa,2017-01-29,2,2,16,4
air_eec5e572b9eb9c23,hpg_e6594f29f40fe2aa,2017-02-01,8,8,8,16
air_eec5e572b9eb9c23,hpg_e6594f29f40fe2aa,2017-02-02,6,6,12,12
air_eec5e572b9eb9c23,hpg_e6594f29f40fe2aa,2017-02-03,16,23,25,39
air_eec5e572b9eb9c23,hpg_e6594f29f40fe2aa,2017-02-04,26,5,39,31
air_eec5e572b9eb9c23,hpg_e6594f29f40fe2aa,2017-02-09,20,20,20,40
air_eec5e572b9eb9c23,hpg_e6594f29f40fe2aa,2017-02-10,22,16,28,38
air_eec5e572b9eb9c23,hpg_e6594f29f40fe2aa,2017-02-15,6,6,6,12
air_eec5e572b9eb9c23,hpg_e6594f29f40fe2aa,2017-02-17,40,46,25,86
air_eec5e572b9eb9c23,hpg_e6594f29f40fe2aa,2017-02-18,25,10,58,35
air_eec5e572b9eb9c23,hpg_e6594f29f40fe2aa,2017-02-19,21,4,17,25
air_eec5e572b9eb9c23,hpg_e6594f29f40fe2aa,2017-02-21,26,22,36,48
air_eec5e572b9eb9c23,hpg_e6594f29f40fe2aa,2017-02-22,4,4,13,8
air_eec5e572b9eb9c23,hpg_e6594f29f40fe2aa,2017-02-24,24,5,21,29
air_eec5e572b9eb9c23,hpg_e6594f29f40fe2aa,2017-02-25,32,18,48,50
air_eec5e572b9eb9c23,hpg_e6594f29f40fe2aa,2017-02-28,5,5,2,10
air_eec5e572b9eb9c23,hpg_e6594f29f40fe2aa,2017-03-06,14,14,14,28
air_eec5e572b9eb9c23,hpg_e6594f29f40fe2aa,2017-03-10,9,9,14,18
air_eec5e572b9eb9c23,hpg_e6594f29f40fe2aa,2017-03-11,4,4,15,8
air_eec5e572b9eb9c23,hpg_e6594f29f40fe2aa,2017-03-12,21,41,31,62
air_eec5e572b9eb9c23,hpg_e6594f29f40fe2aa,2017-03-14,2,2,2,4
air_eec5e572b9eb9c23,hpg_e6594f29f40fe2aa,2017-03-15,5,5,11,10
air_eec5e572b9eb9c23,hpg_e6594f29f40fe2aa,2017-03-16,2,2,12,4
air_eec5e572b9eb9c23,hpg_e6594f29f40fe2aa,2017-03-18,5,3,41,8
air_eec5e572b9eb9c23,hpg_e6594f29f40fe2aa,2017-03-23,7,13,19,20
air_eec5e572b9eb9c23,hpg_e6594f29f40fe2aa,2017-03-25,16,16,16,32
air_eec5e572b9eb9c23,hpg_e6594f29f40fe2aa,2017-03-28,2,2,4,4
air_eec5e572b9eb9c23,hpg_e6594f29f40fe2aa,2017-04-01,19,19,39,38
air_eec5e572b9eb9c23,hpg_e6594f29f40fe2aa,2017-04-04,2,2,2,4
air_eec5e572b9eb9c23,hpg_e6594f29f40fe2aa,2017-04-07,3,3,3,6
air_eec5e572b9eb9c23,hpg_e6594f29f40fe2aa,2017-04-13,2,2,18,4
air_eec5e572b9eb9c23,hpg_e6594f29f40fe2aa,2017-04-14,35,6,35,41
air_eec5e572b9eb9c23,hpg_e6594f29f40fe2aa,2017-04-15,6,2,14,8
air_eec5e572b9eb9c23,hpg_e6594f29f40fe2aa,2017-04-18,1,1,12,2
air_eec5e572b9eb9c23,hpg_e6594f29f40fe2aa,2017-04-22,16,14,18,30
air_90f0efbb702d77b7,hpg_1f7bc96cada52483,2016-11-03,6,6,31,12
air_90f0efbb702d77b7,hpg_1f7bc96cada52483,2016-11-04,2,2,22,4
air_90f0efbb702d77b7,hpg_1f7bc96cada52483,2016-11-06,17,2,34,19
air_90f0efbb702d77b7,hpg_1f7bc96cada52483,2016-11-11,14,14,41,28
air_90f0efbb702d77b7,hpg_1f7bc96cada52483,2016-11-12,18,10,45,28
air_90f0efbb702d77b7,hpg_1f7bc96cada52483,2016-11-22,18,7,79,25
air_90f0efbb702d77b7,hpg_1f7bc96cada52483,2016-12-08,22,8,22,30
air_90f0efbb702d77b7,hpg_1f7bc96cada52483,2016-12-09,12,9,40,21
air_90f0efbb702d77b7,hpg_1f7bc96cada52483,2016-12-10,14,2,49,16
air_90f0efbb702d77b7,hpg_1f7bc96cada52483,2016-12-17,16,5,65,21
air_90f0efbb702d77b7,hpg_1f7bc96cada52483,2016-12-20,35,4,48,39
air_90f0efbb702d77b7,hpg_1f7bc96cada52483,2016-12-22,12,2,39,14
air_90f0efbb702d77b7,hpg_1f7bc96cada52483,2016-12-24,7,2,22,9
air_90f0efbb702d77b7,hpg_1f7bc96cada52483,2016-12-25,11,7,32,18
air_90f0efbb702d77b7,hpg_1f7bc96cada52483,2016-12-27,21,18,47,39
air_90f0efbb702d77b7,hpg_1f7bc96cada52483,2016-12-30,19,16,59,35
air_90f0efbb702d77b7,hpg_1f7bc96cada52483,2017-01-05,2,2,24,4
air_90f0efbb702d77b7,hpg_1f7bc96cada52483,2017-01-14,7,12,42,19
air_90f0efbb702d77b7,hpg_1f7bc96cada52483,2017-01-15,20,4,42,24
air_90f0efbb702d77b7,hpg_1f7bc96cada52483,2017-01-17,2,2,16,4
air_90f0efbb702d77b7,hpg_1f7bc96cada52483,2017-01-24,11,6,28,17
air_90f0efbb702d77b7,hpg_1f7bc96cada52483,2017-01-27,27,6,63,33
air_90f0efbb702d77b7,hpg_1f7bc96cada52483,2017-02-04,12,12,52,24
air_90f0efbb702d77b7,hpg_1f7bc96cada52483,2017-02-09,3,3,12,6
air_90f0efbb702d77b7,hpg_1f7bc96cada52483,2017-02-10,8,4,44,12
air_90f0efbb702d77b7,hpg_1f7bc96cada52483,2017-02-18,2,2,32,4
air_90f0efbb702d77b7,hpg_1f7bc96cada52483,2017-02-27,14,14,33,28
air_90f0efbb702d77b7,hpg_1f7bc96cada52483,2017-03-21,14,3,27,17
air_90f0efbb702d77b7,hpg_1f7bc96cada52483,2017-03-27,2,2,3,4
air_90f0efbb702d77b7,hpg_1f7bc96cada52483,2017-03-28,19,2,66,21
air_90f0efbb702d77b7,hpg_1f7bc96cada52483,2017-04-01,2,2,31,4
air_90f0efbb702d77b7,hpg_1f7bc96cada52483,2017-04-08,34,25,63,59
air_90f0efbb702d77b7,hpg_1f7bc96cada52483,2017-04-10,33,33,48,66
air_90f0efbb702d77b7,hpg_1f7bc96cada52483,2017-04-11,17,35,24,52
air_90f0efbb702d77b7,hpg_1f7bc96cada52483,2017-04-13,6,3,14,9
air_90f0efbb702d77b7,hpg_1f7bc96cada52483,2017-04-14,3,20,30,23
air_90f0efbb702d77b7,hpg_1f7bc96cada52483,2017-04-18,5,5,14,10
air_90f0efbb702d77b7,hpg_1f7bc96cada52483,2017-04-20,4,4,8,8
air_324f7c39a8410e7c,hpg_03946d6b6b1e0332,2016-10-28,2,2,10,4
air_324f7c39a8410e7c,hpg_03946d6b6b1e0332,2016-10-29,16,13,34,29
air_324f7c39a8410e7c,hpg_03946d6b6b1e0332,2016-10-30,11,2,17,13
air_324f7c39a8410e7c,hpg_03946d6b6b1e0332,2016-11-05,16,2,22,18
air_324f7c39a8410e7c,hpg_03946d6b6b1e0332,2016-11-12,6,4,22,10
air_324f7c39a8410e7c,hpg_03946d6b6b1e0332,2016-11-17,7,7,7,14
air_324f7c39a8410e7c,hpg_03946d6b6b1e0332,2016-11-19,19,15,22,34
air_324f7c39a8410e7c,hpg_03946d6b6b1e0332,2016-11-20,6,6,17,12
air_324f7c39a8410e7c,hpg_03946d6b6b1e0332,2016-11-22,4,2,8,6
air_324f7c39a8410e7c,hpg_03946d6b6b1e0332,2016-11-25,9,2,8,11
air_324f7c39a8410e7c,hpg_03946d6b6b1e0332,2016-11-26,17,10,38,27
air_324f7c39a8410e7c,hpg_03946d6b6b1e0332,2016-12-03,23,2,20,25
air_324f7c39a8410e7c,hpg_03946d6b6b1e0332,2016-12-10,22,8,29,30
air_324f7c39a8410e7c,hpg_03946d6b6b1e0332,2016-12-11,7,7,23,14
air_324f7c39a8410e7c,hpg_03946d6b6b1e0332,2016-12-14,10,8,12,18
air_324f7c39a8410e7c,hpg_03946d6b6b1e0332,2016-12-15,6,6,9,12
air_324f7c39a8410e7c,hpg_03946d6b6b1e0332,2016-12-16,18,9,18,27
air_324f7c39a8410e7c,hpg_03946d6b6b1e0332,2016-12-17,27,13,30,40
air_324f7c39a8410e7c,hpg_03946d6b6b1e0332,2016-12-20,10,4,3,14
air_324f7c39a8410e7c,hpg_03946d6b6b1e0332,2016-12-22,30,39,22,69
air_324f7c39a8410e7c,hpg_03946d6b6b1e0332,2016-12-27,8,3,17,11
air_324f7c39a8410e7c,hpg_03946d6b6b1e0332,2016-12-28,23,7,20,30
air_324f7c39a8410e7c,hpg_03946d6b6b1e0332,2016-12-29,13,10,34,23
air_324f7c39a8410e7c,hpg_03946d6b6b1e0332,2016-12-30,23,15,25,38
air_324f7c39a8410e7c,hpg_03946d6b6b1e0332,2016-12-31,23,8,38,31
air_324f7c39a8410e7c,hpg_03946d6b6b1e0332,2017-01-01,18,14,56,32
air_324f7c39a8410e7c,hpg_03946d6b6b1e0332,2017-01-02,24,19,43,43
air_324f7c39a8410e7c,hpg_03946d6b6b1e0332,2017-01-03,24,6,44,30
air_324f7c39a8410e7c,hpg_03946d6b6b1e0332,2017-01-11,4,3,11,7
air_324f7c39a8410e7c,hpg_03946d6b6b1e0332,2017-01-13,9,11,25,20
air_324f7c39a8410e7c,hpg_03946d6b6b1e0332,2017-01-20,4,12,14,16
air_324f7c39a8410e7c,hpg_03946d6b6b1e0332,2017-01-25,5,8,9,13
air_324f7c39a8410e7c,hpg_03946d6b6b1e0332,2017-01-27,6,3,21,9
air_324f7c39a8410e7c,hpg_03946d6b6b1e0332,2017-02-04,13,3,18,16
air_324f7c39a8410e7c,hpg_03946d6b6b1e0332,2017-02-07,7,5,15,12
air_324f7c39a8410e7c,hpg_03946d6b6b1e0332,2017-02-11,9,12,20,21
air_324f7c39a8410e7c,hpg_03946d6b6b1e0332,2017-02-14,2,2,17,4
air_324f7c39a8410e7c,hpg_03946d6b6b1e0332,2017-02-17,9,2,10,11
air_324f7c39a8410e7c,hpg_03946d6b6b1e0332,2017-02-18,7,4,18,11
air_324f7c39a8410e7c,hpg_03946d6b6b1e0332,2017-02-19,10,2,20,12
air_324f7c39a8410e7c,hpg_03946d6b6b1e0332,2017-02-22,4,4,11,8
air_324f7c39a8410e7c,hpg_03946d6b6b1e0332,2017-02-26,2,2,15,4
air_324f7c39a8410e7c,hpg_03946d6b6b1e0332,2017-03-01,2,2,17,4
air_324f7c39a8410e7c,hpg_03946d6b6b1e0332,2017-03-03,7,2,10,9
air_324f7c39a8410e7c,hpg_03946d6b6b1e0332,2017-03-04,8,12,28,20
air_324f7c39a8410e7c,hpg_03946d6b6b1e0332,2017-03-15,5,4,5,9
air_324f7c39a8410e7c,hpg_03946d6b6b1e0332,2017-03-19,2,6,34,8
air_324f7c39a8410e7c,hpg_03946d6b6b1e0332,2017-03-24,22,2,19,24
air_324f7c39a8410e7c,hpg_03946d6b6b1e0332,2017-03-25,14,10,32,24
air_324f7c39a8410e7c,hpg_03946d6b6b1e0332,2017-03-26,3,3,5,6
air_324f7c39a8410e7c,hpg_03946d6b6b1e0332,2017-03-29,9,2,16,11
air_324f7c39a8410e7c,hpg_03946d6b6b1e0332,2017-03-31,13,7,20,20
air_324f7c39a8410e7c,hpg_03946d6b6b1e0332,2017-04-07,8,6,12,14
air_324f7c39a8410e7c,hpg_03946d6b6b1e0332,2017-04-18,7,7,15,14
air_324f7c39a8410e7c,hpg_03946d6b6b1e0332,2017-04-21,19,2,29,21
air_324f7c39a8410e7c,hpg_03946d6b6b1e0332,2017-04-22,8,2,10,10
air_938ef91ecdde6878,hpg_623477d346cf1822,2016-10-29,6,3,23,9
air_938ef91ecdde6878,hpg_623477d346cf1822,2016-11-03,2,2,18,4
air_938ef91ecdde6878,hpg_623477d346cf1822,2016-11-04,8,2,33,10
air_938ef91ecdde6878,hpg_623477d346cf1822,2016-11-30,6,6,24,12
air_938ef91ecdde6878,hpg_623477d346cf1822,2016-12-03,6,2,40,8
air_938ef91ecdde6878,hpg_623477d346cf1822,2016-12-16,21,11,41,32
air_938ef91ecdde6878,hpg_623477d346cf1822,2016-12-21,5,25,30,30
air_938ef91ecdde6878,hpg_623477d346cf1822,2016-12-23,6,2,23,8
air_938ef91ecdde6878,hpg_623477d346cf1822,2016-12-24,10,8,30,18
air_938ef91ecdde6878,hpg_623477d346cf1822,2016-12-25,9,6,59,15
air_938ef91ecdde6878,hpg_623477d346cf1822,2016-12-26,2,5,28,7
air_938ef91ecdde6878,hpg_623477d346cf1822,2016-12-27,4,24,6,28
air_938ef91ecdde6878,hpg_623477d346cf1822,2017-01-03,2,2,17,4
air_938ef91ecdde6878,hpg_623477d346cf1822,2017-01-08,8,6,18,14
air_938ef91ecdde6878,hpg_623477d346cf1822,2017-01-09,16,6,23,22
air_938ef91ecdde6878,hpg_623477d346cf1822,2017-01-23,9,2,23,11
air_938ef91ecdde6878,hpg_623477d346cf1822,2017-01-24,4,4,20,8
air_938ef91ecdde6878,hpg_623477d346cf1822,2017-01-27,6,12,30,18
air_938ef91ecdde6878,hpg_623477d346cf1822,2017-01-30,6,6,15,12
air_938ef91ecdde6878,hpg_623477d346cf1822,2017-02-01,2,2,19,4
air_938ef91ecdde6878,hpg_623477d346cf1822,2017-02-03,3,3,19,6
air_938ef91ecdde6878,hpg_623477d346cf1822,2017-02-04,12,8,46,20
air_938ef91ecdde6878,hpg_623477d346cf1822,2017-02-05,4,4,33,8
air_938ef91ecdde6878,hpg_623477d346cf1822,2017-02-10,8,2,38,10
air_938ef91ecdde6878,hpg_623477d346cf1822,2017-02-11,2,2,41,4
air_938ef91ecdde6878,hpg_623477d346cf1822,2017-02-17,5,5,28,10
air_938ef91ecdde6878,hpg_623477d346cf1822,2017-02-18,8,6,27,14
air_938ef91ecdde6878,hpg_623477d346cf1822,2017-02-21,4,4,16,8
air_938ef91ecdde6878,hpg_623477d346cf1822,2017-02-28,2,2,9,4
air_938ef91ecdde6878,hpg_623477d346cf1822,2017-03-10,7,2,32,9
air_938ef91ecdde6878,hpg_623477d346cf1822,2017-03-13,2,2,23,4
air_938ef91ecdde6878,hpg_623477d346cf1822,2017-03-18,16,28,32,44
air_938ef91ecdde6878,hpg_623477d346cf1822,2017-03-19,12,12,47,24
air_938ef91ecdde6878,hpg_623477d346cf1822,2017-03-20,3,29,20,32
air_938ef91ecdde6878,hpg_623477d346cf1822,2017-03-28,4,2,14,6
air_938ef91ecdde6878,hpg_623477d346cf1822,2017-03-29,2,2,16,4
air_938ef91ecdde6878,hpg_623477d346cf1822,2017-04-03,4,5,16,9
air_938ef91ecdde6878,hpg_623477d346cf1822,2017-04-05,10,2,13,12
air_938ef91ecdde6878,hpg_623477d346cf1822,2017-04-08,6,2,44,8
air_938ef91ecdde6878,hpg_623477d346cf1822,2017-04-09,2,2,8,4
air_938ef91ecdde6878,hpg_623477d346cf1822,2017-04-11,2,2,8,4
air_938ef91ecdde6878,hpg_623477d346cf1822,2017-04-15,14,3,49,17
air_938ef91ecdde6878,hpg_623477d346cf1822,2017-04-16,3,3,23,6
air_938ef91ecdde6878,hpg_623477d346cf1822,2017-04-19,2,2,13,4
air_938ef91ecdde6878,hpg_623477d346cf1822,2017-04-22,10,4,40,14
air_1c0b150f9e696a5f,hpg_68e6c301c14211ee,2017-03-02,12,7,87,19
air_1c0b150f9e696a5f,hpg_68e6c301c14211ee,2017-03-03,6,6,96,12
air_1c0b150f9e696a5f,hpg_68e6c301c14211ee,2017-03-04,8,8,114,16
air_1c0b150f9e696a5f,hpg_68e6c301c14211ee,2017-03-11,6,3,139,9
air_1c0b150f9e696a5f,hpg_68e6c301c14211ee,2017-03-12,2,6,140,8
air_1c0b150f9e696a5f,hpg_68e6c301c14211ee,2017-03-14,2,6,120,8
air_1c0b150f9e696a5f,hpg_68e6c301c14211ee,2017-03-15,9,2,116,11
air_1c0b150f9e696a5f,hpg_68e6c301c14211ee,2017-03-20,2,7,136,9
air_1c0b150f9e696a5f,hpg_68e6c301c14211ee,2017-03-21,13,3,100,16
air_1c0b150f9e696a5f,hpg_68e6c301c14211ee,2017-03-25,2,2,152,4
air_1c0b150f9e696a5f,hpg_68e6c301c14211ee,2017-03-26,12,2,166,14
air_1c0b150f9e696a5f,hpg_68e6c301c14211ee,2017-03-28,4,2,131,6
air_1c0b150f9e696a5f,hpg_68e6c301c14211ee,2017-03-30,10,10,132,20
air_1c0b150f9e696a5f,hpg_68e6c301c14211ee,2017-03-31,2,2,130,4
air_1c0b150f9e696a5f,hpg_68e6c301c14211ee,2017-04-04,29,14,121,43
air_1c0b150f9e696a5f,hpg_68e6c301c14211ee,2017-04-11,8,8,71,16
air_1c0b150f9e696a5f,hpg_68e6c301c14211ee,2017-04-13,18,3,80,21
air_1c0b150f9e696a5f,hpg_68e6c301c14211ee,2017-04-14,12,12,89,24
air_1c0b150f9e696a5f,hpg_68e6c301c14211ee,2017-04-15,9,20,130,29
air_1c0b150f9e696a5f,hpg_68e6c301c14211ee,2017-04-16,18,15,132,33
air_1c0b150f9e696a5f,hpg_68e6c301c14211ee,2017-04-18,25,25,76,50
air_1c0b150f9e696a5f,hpg_68e6c301c14211ee,2017-04-21,7,7,89,14
air_f8233ad00755c35c,hpg_098e4dd30e54fee6,2016-10-27,9,2,54,11
air_f8233ad00755c35c,hpg_098e4dd30e54fee6,2016-10-31,6,2,44,8
air_f8233ad00755c35c,hpg_098e4dd30e54fee6,2016-11-01,4,4,28,8
air_f8233ad00755c35c,hpg_098e4dd30e54fee6,2016-11-02,5,3,47,8
air_f8233ad00755c35c,hpg_098e4dd30e54fee6,2016-11-05,14,3,35,17
air_f8233ad00755c35c,hpg_098e4dd30e54fee6,2016-11-08,2,2,39,4
air_f8233ad00755c35c,hpg_098e4dd30e54fee6,2016-11-10,6,6,45,12
air_f8233ad00755c35c,hpg_098e4dd30e54fee6,2016-11-11,11,9,51,20
air_f8233ad00755c35c,hpg_098e4dd30e54fee6,2016-11-12,19,2,21,21
air_f8233ad00755c35c,hpg_098e4dd30e54fee6,2016-11-14,4,2,32,6
air_f8233ad00755c35c,hpg_098e4dd30e54fee6,2016-11-16,8,2,44,10
air_f8233ad00755c35c,hpg_098e4dd30e54fee6,2016-11-18,15,2,39,17
air_f8233ad00755c35c,hpg_098e4dd30e54fee6,2016-11-19,6,4,8,10
air_f8233ad00755c35c,hpg_098e4dd30e54fee6,2016-11-22,8,4,34,12
air_f8233ad00755c35c,hpg_098e4dd30e54fee6,2016-11-23,5,3,19,8
air_f8233ad00755c35c,hpg_098e4dd30e54fee6,2016-11-28,4,4,42,8
air_f8233ad00755c35c,hpg_098e4dd30e54fee6,2016-11-30,23,4,69,27
air_f8233ad00755c35c,hpg_098e4dd30e54fee6,2016-12-01,7,7,45,14
air_f8233ad00755c35c,hpg_098e4dd30e54fee6,2016-12-02,8,14,54,22
air_f8233ad00755c35c,hpg_098e4dd30e54fee6,2016-12-05,7,7,34,14
air_f8233ad00755c35c,hpg_098e4dd30e54fee6,2016-12-09,16,4,34,20
air_f8233ad00755c35c,hpg_098e4dd30e54fee6,2016-12-10,9,6,33,15
air_f8233ad00755c35c,hpg_098e4dd30e54fee6,2016-12-14,9,5,38,14
air_f8233ad00755c35c,hpg_098e4dd30e54fee6,2016-12-15,10,8,35,18
air_f8233ad00755c35c,hpg_098e4dd30e54fee6,2016-12-16,37,37,75,74
air_f8233ad00755c35c,hpg_098e4dd30e54fee6,2016-12-17,27,10,32,37
air_f8233ad00755c35c,hpg_098e4dd30e54fee6,2016-12-19,4,2,35,6
air_f8233ad00755c35c,hpg_098e4dd30e54fee6,2016-12-20,8,6,36,14
air_f8233ad00755c35c,hpg_098e4dd30e54fee6,2016-12-21,8,20,35,28
air_f8233ad00755c35c,hpg_098e4dd30e54fee6,2016-12-22,23,15,57,38
air_f8233ad00755c35c,hpg_098e4dd30e54fee6,2016-12-23,13,4,38,17
air_f8233ad00755c35c,hpg_098e4dd30e54fee6,2016-12-24,2,20,28,22
air_f8233ad00755c35c,hpg_098e4dd30e54fee6,2016-12-26,12,2,54,14
air_f8233ad00755c35c,hpg_098e4dd30e54fee6,2016-12-29,13,7,33,20
air_f8233ad00755c35c,hpg_098e4dd30e54fee6,2017-01-11,9,2,44,11
air_f8233ad00755c35c,hpg_098e4dd30e54fee6,2017-01-12,23,2,51,25
air_f8233ad00755c35c,hpg_098e4dd30e54fee6,2017-01-14,2,2,8,4
air_f8233ad00755c35c,hpg_098e4dd30e54fee6,2017-01-16,10,6,30,16
air_f8233ad00755c35c,hpg_098e4dd30e54fee6,2017-01-17,2,2,35,4
air_f8233ad00755c35c,hpg_098e4dd30e54fee6,2017-01-19,2,2,26,4
air_f8233ad00755c35c,hpg_098e4dd30e54fee6,2017-01-20,17,6,53,23
air_f8233ad00755c35c,hpg_098e4dd30e54fee6,2017-01-26,18,2,52,20
air_f8233ad00755c35c,hpg_098e4dd30e54fee6,2017-01-27,15,10,39,25
air_f8233ad00755c35c,hpg_098e4dd30e54fee6,2017-01-28,10,2,23,12
air_f8233ad00755c35c,hpg_098e4dd30e54fee6,2017-02-02,13,8,57,21
air_f8233ad00755c35c,hpg_098e4dd30e54fee6,2017-02-04,9,2,22,11
air_f8233ad00755c35c,hpg_098e4dd30e54fee6,2017-02-08,4,2,33,6
air_f8233ad00755c35c,hpg_098e4dd30e54fee6,2017-02-09,5,5,39,10
air_f8233ad00755c35c,hpg_098e4dd30e54fee6,2017-02-10,16,8,53,24
air_f8233ad00755c35c,hpg_098e4dd30e54fee6,2017-02-11,8,5,20,13
air_f8233ad00755c35c,hpg_098e4dd30e54fee6,2017-02-13,11,2,36,13
air_f8233ad00755c35c,hpg_098e4dd30e54fee6,2017-02-14,8,4,40,12
air_f8233ad00755c35c,hpg_098e4dd30e54fee6,2017-02-18,12,8,24,20
air_f8233ad00755c35c,hpg_098e4dd30e54fee6,2017-02-20,7,2,29,9
air_f8233ad00755c35c,hpg_098e4dd30e54fee6,2017-02-22,12,3,42,15
air_f8233ad00755c35c,hpg_098e4dd30e54fee6,2017-02-24,12,2,35,14
air_f8233ad00755c35c,hpg_098e4dd30e54fee6,2017-02-25,30,2,35,32
air_f8233ad00755c35c,hpg_098e4dd30e54fee6,2017-02-27,11,4,32,15
air_f8233ad00755c35c,hpg_098e4dd30e54fee6,2017-03-01,17,2,41,19
air_f8233ad00755c35c,hpg_098e4dd30e54fee6,2017-03-03,12,11,48,23
air_f8233ad00755c35c,hpg_098e4dd30e54fee6,2017-03-04,5,3,13,8
air_f8233ad00755c35c,hpg_098e4dd30e54fee6,2017-03-06,9,9,33,18
air_f8233ad00755c35c,hpg_098e4dd30e54fee6,2017-03-07,17,2,50,19
air_f8233ad00755c35c,hpg_098e4dd30e54fee6,2017-03-14,10,2,43,12
air_f8233ad00755c35c,hpg_098e4dd30e54fee6,2017-03-17,24,2,47,26
air_f8233ad00755c35c,hpg_098e4dd30e54fee6,2017-03-18,13,6,14,19
air_f8233ad00755c35c,hpg_098e4dd30e54fee6,2017-03-19,13,2,24,15
air_f8233ad00755c35c,hpg_098e4dd30e54fee6,2017-03-23,8,2,35,10
air_f8233ad00755c35c,hpg_098e4dd30e54fee6,2017-03-24,22,2,56,24
air_f8233ad00755c35c,hpg_098e4dd30e54fee6,2017-03-25,14,5,18,19
air_f8233ad00755c35c,hpg_098e4dd30e54fee6,2017-03-27,8,5,30,13
air_f8233ad00755c35c,hpg_098e4dd30e54fee6,2017-03-28,13,2,43,15
air_f8233ad00755c35c,hpg_098e4dd30e54fee6,2017-04-01,11,2,11,13
air_f8233ad00755c35c,hpg_098e4dd30e54fee6,2017-04-03,4,2,33,6
air_f8233ad00755c35c,hpg_098e4dd30e54fee6,2017-04-14,13,6,50,19
air_f8233ad00755c35c,hpg_098e4dd30e54fee6,2017-04-17,4,4,30,8
air_f8233ad00755c35c,hpg_098e4dd30e54fee6,2017-04-19,14,5,40,19
air_f8233ad00755c35c,hpg_098e4dd30e54fee6,2017-04-21,18,6,41,24
air_c47aa7493b15f297,hpg_03795a62e1c5f1c3,2016-10-27,23,4,31,27
air_c47aa7493b15f297,hpg_03795a62e1c5f1c3,2016-10-28,20,4,47,24
air_c47aa7493b15f297,hpg_03795a62e1c5f1c3,2016-10-29,20,7,30,27
air_c47aa7493b15f297,hpg_03795a62e1c5f1c3,2016-11-02,27,9,33,36
air_c47aa7493b15f297,hpg_03795a62e1c5f1c3,2016-11-06,4,4,20,8
air_c47aa7493b15f297,hpg_03795a62e1c5f1c3,2016-11-07,12,4,11,16
air_c47aa7493b15f297,hpg_03795a62e1c5f1c3,2016-11-12,16,4,32,20
air_c47aa7493b15f297,hpg_03795a62e1c5f1c3,2016-11-16,12,10,18,22
air_c47aa7493b15f297,hpg_03795a62e1c5f1c3,2016-11-19,33,6,39,39
air_c47aa7493b15f297,hpg_03795a62e1c5f1c3,2016-11-25,23,27,22,50
air_c47aa7493b15f297,hpg_03795a62e1c5f1c3,2016-11-26,23,2,56,25
air_c47aa7493b15f297,hpg_03795a62e1c5f1c3,2016-11-29,15,4,32,19
air_c47aa7493b15f297,hpg_03795a62e1c5f1c3,2016-12-01,9,9,19,18
air_c47aa7493b15f297,hpg_03795a62e1c5f1c3,2016-12-03,31,7,39,38
air_c47aa7493b15f297,hpg_03795a62e1c5f1c3,2016-12-06,30,20,29,50
air_c47aa7493b15f297,hpg_03795a62e1c5f1c3,2016-12-09,41,29,45,70
air_c47aa7493b15f297,hpg_03795a62e1c5f1c3,2016-12-10,25,7,47,32
air_c47aa7493b15f297,hpg_03795a62e1c5f1c3,2016-12-11,27,4,35,31
air_c47aa7493b15f297,hpg_03795a62e1c5f1c3,2016-12-13,20,2,31,22
air_c47aa7493b15f297,hpg_03795a62e1c5f1c3,2016-12-15,30,3,37,33
air_c47aa7493b15f297,hpg_03795a62e1c5f1c3,2016-12-16,28,22,39,50
air_c47aa7493b15f297,hpg_03795a62e1c5f1c3,2016-12-17,38,16,53,54
air_c47aa7493b15f297,hpg_03795a62e1c5f1c3,2016-12-19,21,10,27,31
air_c47aa7493b15f297,hpg_03795a62e1c5f1c3,2016-12-20,22,7,29,29
air_c47aa7493b15f297,hpg_03795a62e1c5f1c3,2016-12-22,40,15,29,55
air_c47aa7493b15f297,hpg_03795a62e1c5f1c3,2016-12-23,35,2,29,37
air_c47aa7493b15f297,hpg_03795a62e1c5f1c3,2016-12-24,14,2,33,16
air_c47aa7493b15f297,hpg_03795a62e1c5f1c3,2016-12-26,22,2,25,24
air_c47aa7493b15f297,hpg_03795a62e1c5f1c3,2016-12-27,58,6,14,64
air_c47aa7493b15f297,hpg_03795a62e1c5f1c3,2016-12-29,35,17,22,52
air_c47aa7493b15f297,hpg_03795a62e1c5f1c3,2016-12-30,37,17,41,54
air_c47aa7493b15f297,hpg_03795a62e1c5f1c3,2017-01-05,8,8,21,16
air_c47aa7493b15f297,hpg_03795a62e1c5f1c3,2017-01-06,8,6,22,14
air_c47aa7493b15f297,hpg_03795a62e1c5f1c3,2017-01-07,13,6,30,19
air_c47aa7493b15f297,hpg_03795a62e1c5f1c3,2017-01-10,7,2,16,9
air_c47aa7493b15f297,hpg_03795a62e1c5f1c3,2017-01-12,16,2,22,18
air_c47aa7493b15f297,hpg_03795a62e1c5f1c3,2017-01-13,13,2,26,15
air_c47aa7493b15f297,hpg_03795a62e1c5f1c3,2017-01-14,21,2,33,23
air_c47aa7493b15f297,hpg_03795a62e1c5f1c3,2017-01-20,35,6,19,41
air_c47aa7493b15f297,hpg_03795a62e1c5f1c3,2017-01-21,24,2,29,26
air_c47aa7493b15f297,hpg_03795a62e1c5f1c3,2017-01-24,4,2,7,6
air_c47aa7493b15f297,hpg_03795a62e1c5f1c3,2017-01-26,27,8,31,35
air_c47aa7493b15f297,hpg_03795a62e1c5f1c3,2017-01-27,29,7,49,36
air_c47aa7493b15f297,hpg_03795a62e1c5f1c3,2017-01-28,42,12,9,54
air_c47aa7493b15f297,hpg_03795a62e1c5f1c3,2017-02-02,7,4,15,11
air_c47aa7493b15f297,hpg_03795a62e1c5f1c3,2017-02-03,24,13,36,37
air_c47aa7493b15f297,hpg_03795a62e1c5f1c3,2017-02-04,32,4,37,36
air_c47aa7493b15f297,hpg_03795a62e1c5f1c3,2017-02-07,2,2,11,4
air_c47aa7493b15f297,hpg_03795a62e1c5f1c3,2017-02-08,8,4,13,12
air_c47aa7493b15f297,hpg_03795a62e1c5f1c3,2017-02-09,20,4,28,24
air_c47aa7493b15f297,hpg_03795a62e1c5f1c3,2017-02-10,16,3,20,19
air_c47aa7493b15f297,hpg_03795a62e1c5f1c3,2017-02-11,15,11,38,26
air_c47aa7493b15f297,hpg_03795a62e1c5f1c3,2017-02-14,7,2,9,9
air_c47aa7493b15f297,hpg_03795a62e1c5f1c3,2017-02-15,11,3,28,14
air_c47aa7493b15f297,hpg_03795a62e1c5f1c3,2017-02-17,24,4,36,28
air_c47aa7493b15f297,hpg_03795a62e1c5f1c3,2017-02-18,40,2,55,42
air_c47aa7493b15f297,hpg_03795a62e1c5f1c3,2017-02-19,2,3,18,5
air_c47aa7493b15f297,hpg_03795a62e1c5f1c3,2017-02-20,7,2,17,9
air_c47aa7493b15f297,hpg_03795a62e1c5f1c3,2017-02-22,10,2,16,12
air_c47aa7493b15f297,hpg_03795a62e1c5f1c3,2017-02-24,32,7,34,39
air_c47aa7493b15f297,hpg_03795a62e1c5f1c3,2017-02-25,37,13,53,50
air_c47aa7493b15f297,hpg_03795a62e1c5f1c3,2017-02-26,12,22,29,34
air_c47aa7493b15f297,hpg_03795a62e1c5f1c3,2017-02-27,20,8,22,28
air_c47aa7493b15f297,hpg_03795a62e1c5f1c3,2017-03-02,11,3,11,14
air_c47aa7493b15f297,hpg_03795a62e1c5f1c3,2017-03-04,18,9,31,27
air_c47aa7493b15f297,hpg_03795a62e1c5f1c3,2017-03-05,7,2,12,9
air_c47aa7493b15f297,hpg_03795a62e1c5f1c3,2017-03-08,33,2,40,35
air_c47aa7493b15f297,hpg_03795a62e1c5f1c3,2017-03-09,11,3,33,14
air_c47aa7493b15f297,hpg_03795a62e1c5f1c3,2017-03-12,22,6,25,28
air_c47aa7493b15f297,hpg_03795a62e1c5f1c3,2017-03-13,10,8,12,18
air_c47aa7493b15f297,hpg_03795a62e1c5f1c3,2017-03-14,13,4,34,17
air_c47aa7493b15f297,hpg_03795a62e1c5f1c3,2017-03-15,17,2,37,19
air_c47aa7493b15f297,hpg_03795a62e1c5f1c3,2017-03-16,6,2,11,8
air_c47aa7493b15f297,hpg_03795a62e1c5f1c3,2017-03-17,36,18,37,54
air_c47aa7493b15f297,hpg_03795a62e1c5f1c3,2017-03-18,15,3,38,18
air_c47aa7493b15f297,hpg_03795a62e1c5f1c3,2017-03-22,18,2,19,20
air_c47aa7493b15f297,hpg_03795a62e1c5f1c3,2017-03-24,55,4,26,59
air_c47aa7493b15f297,hpg_03795a62e1c5f1c3,2017-03-25,21,5,30,26
air_c47aa7493b15f297,hpg_03795a62e1c5f1c3,2017-03-27,6,38,31,44
air_c47aa7493b15f297,hpg_03795a62e1c5f1c3,2017-03-28,38,4,40,42
air_c47aa7493b15f297,hpg_03795a62e1c5f1c3,2017-03-30,17,5,28,22
air_c47aa7493b15f297,hpg_03795a62e1c5f1c3,2017-03-31,30,36,39,66
air_c47aa7493b15f297,hpg_03795a62e1c5f1c3,2017-04-01,35,27,42,62
air_c47aa7493b15f297,hpg_03795a62e1c5f1c3,2017-04-05,4,2,9,6
air_c47aa7493b15f297,hpg_03795a62e1c5f1c3,2017-04-07,16,2,22,18
air_c47aa7493b15f297,hpg_03795a62e1c5f1c3,2017-04-08,38,4,46,42
air_c47aa7493b15f297,hpg_03795a62e1c5f1c3,2017-04-10,3,3,19,6
air_c47aa7493b15f297,hpg_03795a62e1c5f1c3,2017-04-12,6,2,13,8
air_c47aa7493b15f297,hpg_03795a62e1c5f1c3,2017-04-14,39,28,22,67
air_c47aa7493b15f297,hpg_03795a62e1c5f1c3,2017-04-15,33,20,43,53
air_c47aa7493b15f297,hpg_03795a62e1c5f1c3,2017-04-16,8,6,26,14
air_c47aa7493b15f297,hpg_03795a62e1c5f1c3,2017-04-17,9,11,11,20
air_c47aa7493b15f297,hpg_03795a62e1c5f1c3,2017-04-19,9,4,24,13
air_c47aa7493b15f297,hpg_03795a62e1c5f1c3,2017-04-20,4,2,10,6
air_c47aa7493b15f297,hpg_03795a62e1c5f1c3,2017-04-22,24,14,35,38
air_082908692355165e,hpg_b8715d0ac52b1763,2016-02-05,2,4,11,6
air_082908692355165e,hpg_b8715d0ac52b1763,2016-02-12,5,3,52,8
air_082908692355165e,hpg_b8715d0ac52b1763,2016-02-26,6,4,52,10
air_082908692355165e,hpg_b8715d0ac52b1763,2016-02-27,2,2,27,4
air_082908692355165e,hpg_b8715d0ac52b1763,2016-03-18,7,2,40,9
air_082908692355165e,hpg_b8715d0ac52b1763,2016-04-15,2,2,26,4
air_082908692355165e,hpg_b8715d0ac52b1763,2016-04-22,5,5,70,10
air_082908692355165e,hpg_b8715d0ac52b1763,2016-05-10,2,2,34,4
air_082908692355165e,hpg_b8715d0ac52b1763,2016-10-30,4,4,12,8
air_082908692355165e,hpg_b8715d0ac52b1763,2016-12-28,29,31,80,60
air_082908692355165e,hpg_b8715d0ac52b1763,2017-02-08,2,2,60,4
air_082908692355165e,hpg_b8715d0ac52b1763,2017-02-10,3,3,50,6
air_082908692355165e,hpg_b8715d0ac52b1763,2017-04-21,12,5,67,17
air_082908692355165e,hpg_b8715d0ac52b1763,2017-04-22,2,2,5,4
air_fcfbdcf7b1f82c6e,hpg_0b53e00789c2eafe,2016-12-10,30,60,6,90
air_fcfbdcf7b1f82c6e,hpg_0b53e00789c2eafe,2016-12-23,8,8,28,16
air_fcfbdcf7b1f82c6e,hpg_0b53e00789c2eafe,2017-01-14,4,4,18,8
air_fcfbdcf7b1f82c6e,hpg_0b53e00789c2eafe,2017-02-04,19,10,23,29
air_fcfbdcf7b1f82c6e,hpg_0b53e00789c2eafe,2017-02-12,12,4,33,16
air_fcfbdcf7b1f82c6e,hpg_0b53e00789c2eafe,2017-03-04,4,4,25,8
air_fcfbdcf7b1f82c6e,hpg_0b53e00789c2eafe,2017-04-07,18,18,33,36
air_fcfbdcf7b1f82c6e,hpg_0b53e00789c2eafe,2017-04-13,2,2,32,4
air_fcfbdcf7b1f82c6e,hpg_0b53e00789c2eafe,2017-04-17,9,9,42,18
air_bcce1ea4350b7b72,hpg_3347c0399df81142,2016-10-28,12,14,24,26
air_bcce1ea4350b7b72,hpg_3347c0399df81142,2016-10-29,2,2,25,4
air_bcce1ea4350b7b72,hpg_3347c0399df81142,2016-11-27,7,7,21,14
air_bcce1ea4350b7b72,hpg_3347c0399df81142,2016-12-01,9,9,30,18
air_bcce1ea4350b7b72,hpg_3347c0399df81142,2016-12-09,2,8,8,10
air_bcce1ea4350b7b72,hpg_3347c0399df81142,2016-12-10,8,4,65,12
air_bcce1ea4350b7b72,hpg_3347c0399df81142,2016-12-19,7,8,18,15
air_bcce1ea4350b7b72,hpg_3347c0399df81142,2016-12-29,11,2,54,13
air_bcce1ea4350b7b72,hpg_3347c0399df81142,2017-01-13,9,9,22,18
air_bcce1ea4350b7b72,hpg_3347c0399df81142,2017-01-14,12,12,20,24
air_bcce1ea4350b7b72,hpg_3347c0399df81142,2017-01-18,2,2,4,4
air_bcce1ea4350b7b72,hpg_3347c0399df81142,2017-01-20,10,6,19,16
air_bcce1ea4350b7b72,hpg_3347c0399df81142,2017-01-22,8,3,27,11
air_bcce1ea4350b7b72,hpg_3347c0399df81142,2017-02-16,3,3,8,6
air_bcce1ea4350b7b72,hpg_3347c0399df81142,2017-02-17,4,7,17,11
air_bcce1ea4350b7b72,hpg_3347c0399df81142,2017-03-04,17,17,30,34
air_bcce1ea4350b7b72,hpg_3347c0399df81142,2017-03-12,2,2,16,4
air_bcce1ea4350b7b72,hpg_3347c0399df81142,2017-03-24,5,5,16,10
air_bcce1ea4350b7b72,hpg_3347c0399df81142,2017-03-26,3,3,26,6
air_bcce1ea4350b7b72,hpg_3347c0399df81142,2017-04-10,4,4,23,8
air_bcce1ea4350b7b72,hpg_3347c0399df81142,2017-04-14,9,5,33,14
air_bcce1ea4350b7b72,hpg_3347c0399df81142,2017-04-21,8,3,23,11
air_627cabe2fe53f33f,hpg_77706f491ca5a090,2016-10-31,2,2,8,4
air_627cabe2fe53f33f,hpg_77706f491ca5a090,2016-11-04,2,2,18,4
air_627cabe2fe53f33f,hpg_77706f491ca5a090,2016-11-11,8,5,26,13
air_627cabe2fe53f33f,hpg_77706f491ca5a090,2016-11-16,4,2,15,6
air_627cabe2fe53f33f,hpg_77706f491ca5a090,2016-12-02,6,4,16,10
air_627cabe2fe53f33f,hpg_77706f491ca5a090,2016-12-03,11,2,32,13
air_627cabe2fe53f33f,hpg_77706f491ca5a090,2016-12-17,4,4,18,8
air_627cabe2fe53f33f,hpg_77706f491ca5a090,2016-12-22,9,12,25,21
air_627cabe2fe53f33f,hpg_77706f491ca5a090,2016-12-23,6,2,33,8
air_627cabe2fe53f33f,hpg_77706f491ca5a090,2016-12-24,2,11,22,13
air_627cabe2fe53f33f,hpg_77706f491ca5a090,2016-12-28,6,3,28,9
air_627cabe2fe53f33f,hpg_77706f491ca5a090,2016-12-29,10,4,26,14
air_627cabe2fe53f33f,hpg_77706f491ca5a090,2017-01-03,2,5,24,7
air_627cabe2fe53f33f,hpg_77706f491ca5a090,2017-01-20,6,2,17,8
air_627cabe2fe53f33f,hpg_77706f491ca5a090,2017-01-28,4,4,25,8
air_627cabe2fe53f33f,hpg_77706f491ca5a090,2017-01-30,3,7,14,10
air_627cabe2fe53f33f,hpg_77706f491ca5a090,2017-02-14,4,6,14,10
air_627cabe2fe53f33f,hpg_77706f491ca5a090,2017-02-23,6,2,21,8
air_627cabe2fe53f33f,hpg_77706f491ca5a090,2017-03-02,2,2,17,4
air_627cabe2fe53f33f,hpg_77706f491ca5a090,2017-03-03,4,8,14,12
air_627cabe2fe53f33f,hpg_77706f491ca5a090,2017-03-10,3,4,18,7
air_627cabe2fe53f33f,hpg_77706f491ca5a090,2017-03-17,8,2,31,10
air_627cabe2fe53f33f,hpg_77706f491ca5a090,2017-03-18,2,7,29,9
air_627cabe2fe53f33f,hpg_77706f491ca5a090,2017-03-19,11,6,30,17
air_627cabe2fe53f33f,hpg_77706f491ca5a090,2017-03-22,3,3,21,6
air_627cabe2fe53f33f,hpg_77706f491ca5a090,2017-03-24,5,4,27,9
air_627cabe2fe53f33f,hpg_77706f491ca5a090,2017-04-10,2,2,11,4
air_627cabe2fe53f33f,hpg_77706f491ca5a090,2017-04-12,6,6,14,12
air_627cabe2fe53f33f,hpg_77706f491ca5a090,2017-04-14,6,2,19,8
air_627cabe2fe53f33f,hpg_77706f491ca5a090,2017-04-15,20,2,26,22
air_627cabe2fe53f33f,hpg_77706f491ca5a090,2017-04-18,5,5,10,10
air_627cabe2fe53f33f,hpg_77706f491ca5a090,2017-04-21,10,4,14,14
air_627cabe2fe53f33f,hpg_77706f491ca5a090,2017-04-22,6,2,21,8
air_965b2e0cf4119003,hpg_653238a84804d8e7,2016-11-19,2,2,17,4
air_965b2e0cf4119003,hpg_653238a84804d8e7,2016-12-21,9,2,48,11
air_965b2e0cf4119003,hpg_653238a84804d8e7,2017-01-07,10,5,42,15
air_965b2e0cf4119003,hpg_653238a84804d8e7,2017-01-08,12,8,41,20
air_965b2e0cf4119003,hpg_653238a84804d8e7,2017-01-14,21,14,45,35
air_965b2e0cf4119003,hpg_653238a84804d8e7,2017-01-21,19,4,38,23
air_965b2e0cf4119003,hpg_653238a84804d8e7,2017-01-23,16,5,24,21
air_965b2e0cf4119003,hpg_653238a84804d8e7,2017-01-28,27,6,55,33
air_965b2e0cf4119003,hpg_653238a84804d8e7,2017-01-29,12,4,24,16
air_965b2e0cf4119003,hpg_653238a84804d8e7,2017-01-30,13,14,21,27
air_965b2e0cf4119003,hpg_653238a84804d8e7,2017-01-31,11,2,18,13
air_965b2e0cf4119003,hpg_653238a84804d8e7,2017-02-02,5,2,22,7
air_965b2e0cf4119003,hpg_653238a84804d8e7,2017-02-03,26,2,37,28
air_965b2e0cf4119003,hpg_653238a84804d8e7,2017-02-04,26,3,51,29
air_965b2e0cf4119003,hpg_653238a84804d8e7,2017-02-08,23,2,37,25
air_965b2e0cf4119003,hpg_653238a84804d8e7,2017-02-10,24,2,36,26
air_965b2e0cf4119003,hpg_653238a84804d8e7,2017-02-11,22,5,50,27
air_965b2e0cf4119003,hpg_653238a84804d8e7,2017-02-16,22,6,41,28
air_965b2e0cf4119003,hpg_653238a84804d8e7,2017-02-17,21,4,43,25
air_965b2e0cf4119003,hpg_653238a84804d8e7,2017-02-19,8,2,29,10
air_965b2e0cf4119003,hpg_653238a84804d8e7,2017-02-20,20,6,40,26
air_965b2e0cf4119003,hpg_653238a84804d8e7,2017-02-24,37,22,61,59
air_965b2e0cf4119003,hpg_653238a84804d8e7,2017-02-25,29,3,60,32
air_965b2e0cf4119003,hpg_653238a84804d8e7,2017-02-26,15,2,36,17
air_965b2e0cf4119003,hpg_653238a84804d8e7,2017-02-28,5,3,24,8
air_965b2e0cf4119003,hpg_653238a84804d8e7,2017-03-01,10,4,30,14
air_965b2e0cf4119003,hpg_653238a84804d8e7,2017-03-03,31,2,53,33
air_965b2e0cf4119003,hpg_653238a84804d8e7,2017-03-10,27,4,51,31
air_965b2e0cf4119003,hpg_653238a84804d8e7,2017-03-15,22,2,41,24
air_965b2e0cf4119003,hpg_653238a84804d8e7,2017-03-16,19,2,38,21
air_965b2e0cf4119003,hpg_653238a84804d8e7,2017-03-17,25,3,40,28
air_965b2e0cf4119003,hpg_653238a84804d8e7,2017-03-20,24,2,39,26
air_965b2e0cf4119003,hpg_653238a84804d8e7,2017-03-21,17,6,29,23
air_965b2e0cf4119003,hpg_653238a84804d8e7,2017-03-25,27,2,45,29
air_965b2e0cf4119003,hpg_653238a84804d8e7,2017-03-26,24,2,39,26
air_965b2e0cf4119003,hpg_653238a84804d8e7,2017-03-29,26,10,42,36
air_965b2e0cf4119003,hpg_653238a84804d8e7,2017-03-31,30,14,56,44
air_965b2e0cf4119003,hpg_653238a84804d8e7,2017-04-01,17,4,66,21
air_965b2e0cf4119003,hpg_653238a84804d8e7,2017-04-02,25,2,73,27
air_965b2e0cf4119003,hpg_653238a84804d8e7,2017-04-05,22,6,73,28
air_965b2e0cf4119003,hpg_653238a84804d8e7,2017-04-06,10,10,60,20
air_965b2e0cf4119003,hpg_653238a84804d8e7,2017-04-07,19,4,73,23
air_965b2e0cf4119003,hpg_653238a84804d8e7,2017-04-08,25,3,82,28
air_965b2e0cf4119003,hpg_653238a84804d8e7,2017-04-22,31,8,44,39
air_f690c42545146e0a,hpg_0dc016db530f5c33,2016-01-05,2,2,14,4
air_f690c42545146e0a,hpg_0dc016db530f5c33,2016-01-24,8,4,8,12
air_f690c42545146e0a,hpg_0dc016db530f5c33,2016-01-29,19,6,19,25
air_f690c42545146e0a,hpg_0dc016db530f5c33,2016-02-04,3,3,2,6
air_f690c42545146e0a,hpg_0dc016db530f5c33,2016-02-05,8,6,8,14
air_f690c42545146e0a,hpg_0dc016db530f5c33,2016-02-06,17,4,15,21
air_f690c42545146e0a,hpg_0dc016db530f5c33,2016-02-12,34,4,34,38
air_f690c42545146e0a,hpg_0dc016db530f5c33,2016-02-27,6,2,6,8
air_f690c42545146e0a,hpg_0dc016db530f5c33,2016-03-05,10,2,10,12
air_f690c42545146e0a,hpg_0dc016db530f5c33,2016-03-10,2,2,2,4
air_f690c42545146e0a,hpg_0dc016db530f5c33,2016-03-11,7,4,7,11
air_f690c42545146e0a,hpg_0dc016db530f5c33,2016-03-18,42,2,46,44
air_f690c42545146e0a,hpg_0dc016db530f5c33,2016-03-20,12,2,12,14
air_f690c42545146e0a,hpg_0dc016db530f5c33,2016-03-21,10,10,9,20
air_f690c42545146e0a,hpg_0dc016db530f5c33,2016-03-25,48,17,48,65
air_f690c42545146e0a,hpg_0dc016db530f5c33,2016-04-18,4,4,4,8
air_f690c42545146e0a,hpg_0dc016db530f5c33,2016-04-22,18,10,18,28
air_f690c42545146e0a,hpg_0dc016db530f5c33,2016-04-29,2,2,4,4
air_f690c42545146e0a,hpg_0dc016db530f5c33,2016-05-13,29,15,30,44
air_f690c42545146e0a,hpg_0dc016db530f5c33,2016-05-19,2,2,2,4
air_f690c42545146e0a,hpg_0dc016db530f5c33,2016-05-20,21,17,21,38
air_f690c42545146e0a,hpg_0dc016db530f5c33,2016-05-21,5,2,5,7
air_f690c42545146e0a,hpg_0dc016db530f5c33,2016-10-27,6,3,3,9
air_f690c42545146e0a,hpg_0dc016db530f5c33,2016-10-29,13,10,13,23
air_f690c42545146e0a,hpg_0dc016db530f5c33,2016-11-04,40,2,40,42
air_f690c42545146e0a,hpg_0dc016db530f5c33,2016-11-05,8,2,8,10
air_f690c42545146e0a,hpg_0dc016db530f5c33,2016-11-11,14,12,14,26
air_f690c42545146e0a,hpg_0dc016db530f5c33,2016-11-25,8,3,8,11
air_f690c42545146e0a,hpg_0dc016db530f5c33,2016-12-02,55,3,47,58
air_f690c42545146e0a,hpg_0dc016db530f5c33,2016-12-03,43,17,41,60
air_f690c42545146e0a,hpg_0dc016db530f5c33,2016-12-09,59,2,47,61
air_f690c42545146e0a,hpg_0dc016db530f5c33,2016-12-10,12,4,3,16
air_f690c42545146e0a,hpg_0dc016db530f5c33,2016-12-12,2,15,2,17
air_f690c42545146e0a,hpg_0dc016db530f5c33,2016-12-16,51,2,45,53
air_f690c42545146e0a,hpg_0dc016db530f5c33,2016-12-17,36,15,30,51
air_f690c42545146e0a,hpg_0dc016db530f5c33,2016-12-22,37,11,12,48
air_f690c42545146e0a,hpg_0dc016db530f5c33,2016-12-28,36,4,32,40
air_f690c42545146e0a,hpg_0dc016db530f5c33,2016-12-31,6,6,4,12
air_f690c42545146e0a,hpg_0dc016db530f5c33,2017-01-07,14,10,5,24
air_f690c42545146e0a,hpg_0dc016db530f5c33,2017-01-28,6,6,4,12
air_f690c42545146e0a,hpg_0dc016db530f5c33,2017-02-17,23,2,10,25
air_f690c42545146e0a,hpg_0dc016db530f5c33,2017-02-24,31,8,23,39
air_f690c42545146e0a,hpg_0dc016db530f5c33,2017-03-10,15,3,5,18
air_f690c42545146e0a,hpg_0dc016db530f5c33,2017-03-17,19,4,13,23
air_f690c42545146e0a,hpg_0dc016db530f5c33,2017-03-18,20,5,13,25
air_f690c42545146e0a,hpg_0dc016db530f5c33,2017-03-28,2,2,2,4
air_f690c42545146e0a,hpg_0dc016db530f5c33,2017-03-30,12,4,4,16
air_f690c42545146e0a,hpg_0dc016db530f5c33,2017-04-07,6,2,2,8
air_f690c42545146e0a,hpg_0dc016db530f5c33,2017-04-22,26,6,12,32
air_c7f78b4f3cba33ff,hpg_cd8ae0d9bbd58ff9,2016-10-27,29,6,39,35
air_c7f78b4f3cba33ff,hpg_cd8ae0d9bbd58ff9,2016-11-11,16,4,38,20
air_c7f78b4f3cba33ff,hpg_cd8ae0d9bbd58ff9,2016-11-12,6,6,48,12
air_c7f78b4f3cba33ff,hpg_cd8ae0d9bbd58ff9,2016-11-17,3,3,26,6
air_c7f78b4f3cba33ff,hpg_cd8ae0d9bbd58ff9,2016-12-09,16,4,36,20
air_c7f78b4f3cba33ff,hpg_cd8ae0d9bbd58ff9,2016-12-16,26,2,44,28
air_c7f78b4f3cba33ff,hpg_cd8ae0d9bbd58ff9,2016-12-22,31,12,31,43
air_c7f78b4f3cba33ff,hpg_cd8ae0d9bbd58ff9,2017-01-18,8,3,19,11
air_c7f78b4f3cba33ff,hpg_cd8ae0d9bbd58ff9,2017-01-19,26,3,35,29
air_c7f78b4f3cba33ff,hpg_cd8ae0d9bbd58ff9,2017-02-28,12,8,33,20
air_c7f78b4f3cba33ff,hpg_cd8ae0d9bbd58ff9,2017-03-16,26,3,34,29
air_c7f78b4f3cba33ff,hpg_cd8ae0d9bbd58ff9,2017-03-27,4,4,18,8
air_c7f78b4f3cba33ff,hpg_cd8ae0d9bbd58ff9,2017-03-29,27,14,36,41
air_c7f78b4f3cba33ff,hpg_cd8ae0d9bbd58ff9,2017-04-11,23,4,34,27
air_c7f78b4f3cba33ff,hpg_cd8ae0d9bbd58ff9,2017-04-13,12,7,27,19
air_b2d97bd2337c5ba7,hpg_67c2b78265118491,2016-07-02,13,2,51,15
air_b2d97bd2337c5ba7,hpg_67c2b78265118491,2016-07-03,2,2,41,4
air_b2d97bd2337c5ba7,hpg_67c2b78265118491,2017-01-22,4,6,53,10
air_b2d97bd2337c5ba7,hpg_67c2b78265118491,2017-02-12,3,7,34,10
air_6b2268863b14a2af,hpg_7664eec3cd802c91,2016-10-29,2,2,19,4
air_6b2268863b14a2af,hpg_7664eec3cd802c91,2016-11-14,2,2,16,4
air_6b2268863b14a2af,hpg_7664eec3cd802c91,2016-12-02,3,3,24,6
air_6b2268863b14a2af,hpg_7664eec3cd802c91,2016-12-28,5,9,30,14
air_6b2268863b14a2af,hpg_7664eec3cd802c91,2017-01-09,3,3,19,6
air_6b2268863b14a2af,hpg_7664eec3cd802c91,2017-01-28,5,9,41,14
air_6b2268863b14a2af,hpg_7664eec3cd802c91,2017-04-01,2,2,16,4
air_6b2268863b14a2af,hpg_7664eec3cd802c91,2017-04-07,2,8,33,10
air_6b2268863b14a2af,hpg_7664eec3cd802c91,2017-04-08,2,2,12,4
air_a24bf50c3e90d583,hpg_c34b496d0305a809,2016-07-08,10,2,21,12
air_a24bf50c3e90d583,hpg_c34b496d0305a809,2016-07-09,7,10,59,17
air_a24bf50c3e90d583,hpg_c34b496d0305a809,2016-07-11,12,3,33,15
air_a24bf50c3e90d583,hpg_c34b496d0305a809,2016-10-28,8,8,18,16
air_a24bf50c3e90d583,hpg_c34b496d0305a809,2016-10-29,36,34,42,70
air_a24bf50c3e90d583,hpg_c34b496d0305a809,2016-11-02,5,5,26,10
air_a24bf50c3e90d583,hpg_c34b496d0305a809,2016-11-05,2,4,32,6
air_a24bf50c3e90d583,hpg_c34b496d0305a809,2016-11-10,3,3,13,6
air_a24bf50c3e90d583,hpg_c34b496d0305a809,2016-11-11,17,13,23,30
air_a24bf50c3e90d583,hpg_c34b496d0305a809,2016-11-12,16,4,61,20
air_a24bf50c3e90d583,hpg_c34b496d0305a809,2016-11-18,24,3,31,27
air_a24bf50c3e90d583,hpg_c34b496d0305a809,2016-11-19,32,13,36,45
air_a24bf50c3e90d583,hpg_c34b496d0305a809,2016-11-25,12,4,19,16
air_a24bf50c3e90d583,hpg_c34b496d0305a809,2016-12-02,11,4,15,15
air_a24bf50c3e90d583,hpg_c34b496d0305a809,2016-12-03,34,42,50,76
air_a24bf50c3e90d583,hpg_c34b496d0305a809,2016-12-05,18,6,18,24
air_a24bf50c3e90d583,hpg_c34b496d0305a809,2016-12-06,10,10,35,20
air_a24bf50c3e90d583,hpg_c34b496d0305a809,2016-12-07,5,5,11,10
air_a24bf50c3e90d583,hpg_c34b496d0305a809,2016-12-10,36,59,39,95
air_a24bf50c3e90d583,hpg_c34b496d0305a809,2016-12-15,7,2,18,9
air_a24bf50c3e90d583,hpg_c34b496d0305a809,2016-12-16,27,40,33,67
air_a24bf50c3e90d583,hpg_c34b496d0305a809,2016-12-17,33,74,43,107
air_a24bf50c3e90d583,hpg_c34b496d0305a809,2016-12-19,14,13,27,27
air_a24bf50c3e90d583,hpg_c34b496d0305a809,2016-12-20,9,7,19,16
air_a24bf50c3e90d583,hpg_c34b496d0305a809,2016-12-21,8,2,14,10
air_a24bf50c3e90d583,hpg_c34b496d0305a809,2016-12-22,26,46,34,72
air_a24bf50c3e90d583,hpg_c34b496d0305a809,2016-12-23,6,8,14,14
air_a24bf50c3e90d583,hpg_c34b496d0305a809,2016-12-24,13,11,24,24
air_a24bf50c3e90d583,hpg_c34b496d0305a809,2016-12-25,11,6,27,17
air_a24bf50c3e90d583,hpg_c34b496d0305a809,2016-12-26,10,6,22,16
air_a24bf50c3e90d583,hpg_c34b496d0305a809,2016-12-27,13,4,28,17
air_a24bf50c3e90d583,hpg_c34b496d0305a809,2016-12-28,30,52,47,82
air_a24bf50c3e90d583,hpg_c34b496d0305a809,2016-12-29,39,29,76,68
air_a24bf50c3e90d583,hpg_c34b496d0305a809,2016-12-30,44,24,64,68
air_a24bf50c3e90d583,hpg_c34b496d0305a809,2017-01-03,18,14,30,32
air_a24bf50c3e90d583,hpg_c34b496d0305a809,2017-01-06,26,26,31,52
air_a24bf50c3e90d583,hpg_c34b496d0305a809,2017-01-07,8,20,40,28
air_a24bf50c3e90d583,hpg_c34b496d0305a809,2017-01-12,8,4,18,12
air_a24bf50c3e90d583,hpg_c34b496d0305a809,2017-01-17,14,8,27,22
air_a24bf50c3e90d583,hpg_c34b496d0305a809,2017-01-18,2,2,8,4
air_a24bf50c3e90d583,hpg_c34b496d0305a809,2017-01-20,17,10,26,27
air_a24bf50c3e90d583,hpg_c34b496d0305a809,2017-01-21,2,2,27,4
air_a24bf50c3e90d583,hpg_c34b496d0305a809,2017-01-23,4,4,12,8
air_a24bf50c3e90d583,hpg_c34b496d0305a809,2017-01-27,5,5,14,10
air_a24bf50c3e90d583,hpg_c34b496d0305a809,2017-01-28,21,2,46,23
air_a24bf50c3e90d583,hpg_c34b496d0305a809,2017-01-31,16,12,26,28
air_a24bf50c3e90d583,hpg_c34b496d0305a809,2017-02-03,4,2,15,6
air_a24bf50c3e90d583,hpg_c34b496d0305a809,2017-02-04,24,6,39,30
air_a24bf50c3e90d583,hpg_c34b496d0305a809,2017-02-08,11,7,16,18
air_a24bf50c3e90d583,hpg_c34b496d0305a809,2017-02-15,7,2,25,9
air_a24bf50c3e90d583,hpg_c34b496d0305a809,2017-02-16,6,6,10,12
air_a24bf50c3e90d583,hpg_c34b496d0305a809,2017-02-17,12,10,39,22
air_a24bf50c3e90d583,hpg_c34b496d0305a809,2017-02-18,23,4,27,27
air_a24bf50c3e90d583,hpg_c34b496d0305a809,2017-02-20,6,6,22,12
air_a24bf50c3e90d583,hpg_c34b496d0305a809,2017-02-22,2,3,14,5
air_a24bf50c3e90d583,hpg_c34b496d0305a809,2017-02-23,28,3,36,31
air_a24bf50c3e90d583,hpg_c34b496d0305a809,2017-02-24,8,4,17,12
air_a24bf50c3e90d583,hpg_c34b496d0305a809,2017-02-25,23,11,55,34
air_a24bf50c3e90d583,hpg_c34b496d0305a809,2017-02-28,2,2,22,4
air_a24bf50c3e90d583,hpg_c34b496d0305a809,2017-03-03,11,4,24,15
air_a24bf50c3e90d583,hpg_c34b496d0305a809,2017-03-04,17,2,42,19
air_a24bf50c3e90d583,hpg_c34b496d0305a809,2017-03-06,18,7,27,25
air_a24bf50c3e90d583,hpg_c34b496d0305a809,2017-03-08,12,6,18,18
air_a24bf50c3e90d583,hpg_c34b496d0305a809,2017-03-09,6,2,15,8
air_a24bf50c3e90d583,hpg_c34b496d0305a809,2017-03-10,23,11,33,34
air_a24bf50c3e90d583,hpg_c34b496d0305a809,2017-03-11,18,5,33,23
air_a24bf50c3e90d583,hpg_c34b496d0305a809,2017-03-13,3,3,14,6
air_a24bf50c3e90d583,hpg_c34b496d0305a809,2017-03-14,2,4,17,6
air_a24bf50c3e90d583,hpg_c34b496d0305a809,2017-03-16,4,4,45,8
air_a24bf50c3e90d583,hpg_c34b496d0305a809,2017-03-17,3,3,12,6
air_a24bf50c3e90d583,hpg_c34b496d0305a809,2017-03-18,18,8,24,26
air_a24bf50c3e90d583,hpg_c34b496d0305a809,2017-03-20,6,4,42,10
air_a24bf50c3e90d583,hpg_c34b496d0305a809,2017-03-21,3,3,13,6
air_a24bf50c3e90d583,hpg_c34b496d0305a809,2017-03-24,5,5,14,10
air_a24bf50c3e90d583,hpg_c34b496d0305a809,2017-03-25,16,13,40,29
air_a24bf50c3e90d583,hpg_c34b496d0305a809,2017-03-28,2,2,11,4
air_a24bf50c3e90d583,hpg_c34b496d0305a809,2017-03-29,12,2,21,14
air_a24bf50c3e90d583,hpg_c34b496d0305a809,2017-03-30,4,4,13,8
air_a24bf50c3e90d583,hpg_c34b496d0305a809,2017-03-31,24,3,28,27
air_a24bf50c3e90d583,hpg_c34b496d0305a809,2017-04-05,3,3,19,6
air_a24bf50c3e90d583,hpg_c34b496d0305a809,2017-04-06,13,2,19,15
air_a24bf50c3e90d583,hpg_c34b496d0305a809,2017-04-08,11,11,33,22
air_a24bf50c3e90d583,hpg_c34b496d0305a809,2017-04-14,25,18,31,43
air_a24bf50c3e90d583,hpg_c34b496d0305a809,2017-04-15,16,14,35,30
air_a24bf50c3e90d583,hpg_c34b496d0305a809,2017-04-19,2,2,13,4
air_a24bf50c3e90d583,hpg_c34b496d0305a809,2017-04-21,2,2,21,4
air_a24bf50c3e90d583,hpg_c34b496d0305a809,2017-04-22,17,2,40,19
air_ee3ba9af184c6c82,hpg_fc892fe8d342a787,2016-10-29,18,14,10,32
air_ee3ba9af184c6c82,hpg_fc892fe8d342a787,2016-11-07,25,24,31,49
air_ee3ba9af184c6c82,hpg_fc892fe8d342a787,2016-11-18,16,2,28,18
air_ee3ba9af184c6c82,hpg_fc892fe8d342a787,2016-11-22,8,2,7,10
air_ee3ba9af184c6c82,hpg_fc892fe8d342a787,2016-11-25,30,34,33,64
air_ee3ba9af184c6c82,hpg_fc892fe8d342a787,2016-11-26,27,24,28,51
air_ee3ba9af184c6c82,hpg_fc892fe8d342a787,2016-12-02,28,9,29,37
air_ee3ba9af184c6c82,hpg_fc892fe8d342a787,2016-12-03,30,5,31,35
air_ee3ba9af184c6c82,hpg_fc892fe8d342a787,2016-12-08,8,3,6,11
air_ee3ba9af184c6c82,hpg_fc892fe8d342a787,2016-12-10,32,17,32,49
air_ee3ba9af184c6c82,hpg_fc892fe8d342a787,2016-12-15,21,2,21,23
air_ee3ba9af184c6c82,hpg_fc892fe8d342a787,2016-12-16,30,10,31,40
air_ee3ba9af184c6c82,hpg_fc892fe8d342a787,2016-12-21,15,4,17,19
air_ee3ba9af184c6c82,hpg_fc892fe8d342a787,2016-12-22,16,21,16,37
air_ee3ba9af184c6c82,hpg_fc892fe8d342a787,2017-02-04,28,3,3,31
air_ee3ba9af184c6c82,hpg_fc892fe8d342a787,2017-02-10,20,18,13,38
air_ee3ba9af184c6c82,hpg_fc892fe8d342a787,2017-02-18,23,15,17,38
air_ee3ba9af184c6c82,hpg_fc892fe8d342a787,2017-03-11,16,14,2,30
air_ee3ba9af184c6c82,hpg_fc892fe8d342a787,2017-03-15,17,13,4,30
air_ee3ba9af184c6c82,hpg_fc892fe8d342a787,2017-03-17,12,3,14,15
air_ee3ba9af184c6c82,hpg_fc892fe8d342a787,2017-03-18,17,4,18,21
air_ee3ba9af184c6c82,hpg_fc892fe8d342a787,2017-04-07,20,10,6,30
air_ee3ba9af184c6c82,hpg_fc892fe8d342a787,2017-04-08,27,7,27,34
air_ee3ba9af184c6c82,hpg_fc892fe8d342a787,2017-04-12,16,16,16,32
air_ee3ba9af184c6c82,hpg_fc892fe8d342a787,2017-04-14,32,18,33,50
air_ee3ba9af184c6c82,hpg_fc892fe8d342a787,2017-04-15,21,4,27,25
air_ee3ba9af184c6c82,hpg_fc892fe8d342a787,2017-04-17,22,13,25,35
air_ee3ba9af184c6c82,hpg_fc892fe8d342a787,2017-04-18,11,2,13,13
air_ee3ba9af184c6c82,hpg_fc892fe8d342a787,2017-04-19,34,22,34,56
air_ee3ba9af184c6c82,hpg_fc892fe8d342a787,2017-04-21,32,11,33,43
air_ee3ba9af184c6c82,hpg_fc892fe8d342a787,2017-04-22,28,17,13,45
air_b4f32bcc399da2b9,hpg_95875f687b36070f,2016-02-01,2,2,12,4
air_b4f32bcc399da2b9,hpg_95875f687b36070f,2016-02-15,2,2,22,4
air_b4f32bcc399da2b9,hpg_95875f687b36070f,2016-02-25,24,4,27,28
air_b4f32bcc399da2b9,hpg_95875f687b36070f,2016-02-27,57,15,78,72
air_b4f32bcc399da2b9,hpg_95875f687b36070f,2016-02-28,35,35,96,70
air_b4f32bcc399da2b9,hpg_95875f687b36070f,2016-03-14,2,2,21,4
air_b4f32bcc399da2b9,hpg_95875f687b36070f,2016-03-18,25,30,43,55
air_b4f32bcc399da2b9,hpg_95875f687b36070f,2016-03-25,23,2,46,25
air_b4f32bcc399da2b9,hpg_95875f687b36070f,2016-03-26,26,25,63,51
air_b4f32bcc399da2b9,hpg_95875f687b36070f,2016-04-04,2,2,11,4
air_b4f32bcc399da2b9,hpg_95875f687b36070f,2016-04-23,40,45,91,85
air_b4f32bcc399da2b9,hpg_95875f687b36070f,2016-05-07,40,14,27,54
air_b4f32bcc399da2b9,hpg_95875f687b36070f,2016-05-12,16,16,24,32
air_b4f32bcc399da2b9,hpg_95875f687b36070f,2016-06-01,2,2,16,4
air_b4f32bcc399da2b9,hpg_95875f687b36070f,2016-06-04,75,18,83,93
air_b4f32bcc399da2b9,hpg_95875f687b36070f,2016-06-06,2,2,24,4
air_b4f32bcc399da2b9,hpg_95875f687b36070f,2016-06-20,3,3,22,6
air_b4f32bcc399da2b9,hpg_95875f687b36070f,2016-06-22,3,3,8,6
air_b4f32bcc399da2b9,hpg_95875f687b36070f,2016-06-24,4,4,28,8
air_b4f32bcc399da2b9,hpg_95875f687b36070f,2016-06-29,2,2,26,4
air_b4f32bcc399da2b9,hpg_95875f687b36070f,2016-07-09,5,2,68,7
air_b4f32bcc399da2b9,hpg_95875f687b36070f,2016-07-14,3,33,12,36
air_b4f32bcc399da2b9,hpg_95875f687b36070f,2016-10-27,13,17,31,30
air_b4f32bcc399da2b9,hpg_95875f687b36070f,2016-10-29,31,12,58,43
air_b4f32bcc399da2b9,hpg_95875f687b36070f,2016-10-30,6,5,35,11
air_b4f32bcc399da2b9,hpg_95875f687b36070f,2016-11-05,45,25,28,70
air_b4f32bcc399da2b9,hpg_95875f687b36070f,2016-12-04,4,4,33,8
air_b4f32bcc399da2b9,hpg_95875f687b36070f,2016-12-11,7,4,59,11
air_b4f32bcc399da2b9,hpg_95875f687b36070f,2016-12-17,80,54,89,134
air_b4f32bcc399da2b9,hpg_95875f687b36070f,2016-12-21,4,4,27,8
air_b4f32bcc399da2b9,hpg_95875f687b36070f,2016-12-22,43,46,55,89
air_b4f32bcc399da2b9,hpg_95875f687b36070f,2016-12-24,2,2,68,4
air_b4f32bcc399da2b9,hpg_95875f687b36070f,2016-12-28,17,6,24,23
air_b4f32bcc399da2b9,hpg_95875f687b36070f,2016-12-29,6,9,83,15
air_b4f32bcc399da2b9,hpg_95875f687b36070f,2017-01-02,20,20,39,40
air_b4f32bcc399da2b9,hpg_95875f687b36070f,2017-01-08,34,90,100,124
air_b4f32bcc399da2b9,hpg_95875f687b36070f,2017-01-28,35,33,70,68
air_b4f32bcc399da2b9,hpg_95875f687b36070f,2017-02-01,6,6,11,12
air_b4f32bcc399da2b9,hpg_95875f687b36070f,2017-02-05,7,7,44,14
air_b4f32bcc399da2b9,hpg_95875f687b36070f,2017-02-10,30,30,42,60
air_b4f32bcc399da2b9,hpg_95875f687b36070f,2017-02-11,25,25,38,50
air_b4f32bcc399da2b9,hpg_95875f687b36070f,2017-02-22,6,6,9,12
air_b4f32bcc399da2b9,hpg_95875f687b36070f,2017-03-05,25,25,93,50
air_b4f32bcc399da2b9,hpg_95875f687b36070f,2017-03-10,12,12,42,24
air_b4f32bcc399da2b9,hpg_95875f687b36070f,2017-03-18,6,6,42,12
air_b4f32bcc399da2b9,hpg_95875f687b36070f,2017-03-23,16,12,4,28
air_b4f32bcc399da2b9,hpg_95875f687b36070f,2017-04-22,91,2,48,93
air_c73d319ffabf287a,hpg_e8f879fcbf993278,2016-01-08,20,2,24,22
air_c73d319ffabf287a,hpg_e8f879fcbf993278,2016-01-15,2,6,17,8
air_c73d319ffabf287a,hpg_e8f879fcbf993278,2016-02-03,4,4,9,8
air_c73d319ffabf287a,hpg_e8f879fcbf993278,2016-02-10,11,11,24,22
air_c73d319ffabf287a,hpg_e8f879fcbf993278,2016-02-12,18,2,32,20
air_c73d319ffabf287a,hpg_e8f879fcbf993278,2016-02-13,12,4,28,16
air_c73d319ffabf287a,hpg_e8f879fcbf993278,2016-02-20,2,4,21,6
air_c73d319ffabf287a,hpg_e8f879fcbf993278,2016-02-25,4,4,13,8
air_c73d319ffabf287a,hpg_e8f879fcbf993278,2016-03-04,8,3,21,11
air_c73d319ffabf287a,hpg_e8f879fcbf993278,2016-03-11,16,4,31,20
air_c73d319ffabf287a,hpg_e8f879fcbf993278,2016-03-18,5,15,21,20
air_c73d319ffabf287a,hpg_e8f879fcbf993278,2016-03-19,18,6,29,24
air_c73d319ffabf287a,hpg_e8f879fcbf993278,2016-03-21,6,2,12,8
air_c73d319ffabf287a,hpg_e8f879fcbf993278,2016-03-22,10,10,24,20
air_c73d319ffabf287a,hpg_e8f879fcbf993278,2016-03-23,6,6,19,12
air_c73d319ffabf287a,hpg_e8f879fcbf993278,2016-03-28,16,12,27,28
air_c73d319ffabf287a,hpg_e8f879fcbf993278,2016-04-01,7,7,20,14
air_c73d319ffabf287a,hpg_e8f879fcbf993278,2016-04-02,7,4,24,11
air_c73d319ffabf287a,hpg_e8f879fcbf993278,2016-04-15,12,8,24,20
air_c73d319ffabf287a,hpg_e8f879fcbf993278,2016-04-16,2,2,20,4
air_c73d319ffabf287a,hpg_e8f879fcbf993278,2016-04-22,5,5,24,10
air_c73d319ffabf287a,hpg_e8f879fcbf993278,2016-04-23,14,14,29,28
air_c73d319ffabf287a,hpg_e8f879fcbf993278,2016-04-27,11,11,21,22
air_c73d319ffabf287a,hpg_e8f879fcbf993278,2016-04-28,13,3,28,16
air_c73d319ffabf287a,hpg_e8f879fcbf993278,2016-04-30,6,6,20,12
air_c73d319ffabf287a,hpg_e8f879fcbf993278,2016-05-02,8,2,13,10
air_c73d319ffabf287a,hpg_e8f879fcbf993278,2016-05-03,2,2,10,4
air_c73d319ffabf287a,hpg_e8f879fcbf993278,2016-10-28,9,9,18,18
air_c73d319ffabf287a,hpg_e8f879fcbf993278,2016-10-29,6,6,26,12
air_c73d319ffabf287a,hpg_e8f879fcbf993278,2016-11-01,2,2,5,4
air_c73d319ffabf287a,hpg_e8f879fcbf993278,2016-11-07,2,2,14,4
air_c73d319ffabf287a,hpg_e8f879fcbf993278,2016-11-08,2,2,13,4
air_c73d319ffabf287a,hpg_e8f879fcbf993278,2016-11-11,2,2,6,4
air_c73d319ffabf287a,hpg_e8f879fcbf993278,2016-11-17,6,6,16,12
air_c73d319ffabf287a,hpg_e8f879fcbf993278,2016-11-25,11,7,22,18
air_c73d319ffabf287a,hpg_e8f879fcbf993278,2016-12-05,4,4,10,8
air_c73d319ffabf287a,hpg_e8f879fcbf993278,2016-12-07,5,5,19,10
air_c73d319ffabf287a,hpg_e8f879fcbf993278,2016-12-09,16,10,28,26
air_c73d319ffabf287a,hpg_e8f879fcbf993278,2016-12-10,4,4,40,8
air_c73d319ffabf287a,hpg_e8f879fcbf993278,2016-12-14,5,5,19,10
air_c73d319ffabf287a,hpg_e8f879fcbf993278,2016-12-16,8,10,14,18
air_c73d319ffabf287a,hpg_e8f879fcbf993278,2016-12-17,14,2,32,16
air_c73d319ffabf287a,hpg_e8f879fcbf993278,2016-12-22,20,14,20,34
air_c73d319ffabf287a,hpg_e8f879fcbf993278,2016-12-24,9,8,23,17
air_c73d319ffabf287a,hpg_e8f879fcbf993278,2016-12-26,10,6,19,16
air_c73d319ffabf287a,hpg_e8f879fcbf993278,2016-12-28,17,2,23,19
air_c73d319ffabf287a,hpg_e8f879fcbf993278,2016-12-29,22,15,25,37
air_c73d319ffabf287a,hpg_e8f879fcbf993278,2017-01-04,2,2,22,4
air_c73d319ffabf287a,hpg_e8f879fcbf993278,2017-01-07,5,5,18,10
air_c73d319ffabf287a,hpg_e8f879fcbf993278,2017-01-13,17,17,18,34
air_c73d319ffabf287a,hpg_e8f879fcbf993278,2017-01-14,6,14,19,20
air_c73d319ffabf287a,hpg_e8f879fcbf993278,2017-01-26,2,2,17,4
air_c73d319ffabf287a,hpg_e8f879fcbf993278,2017-02-03,2,2,14,4
air_c73d319ffabf287a,hpg_e8f879fcbf993278,2017-02-04,5,2,19,7
air_c73d319ffabf287a,hpg_e8f879fcbf993278,2017-02-09,4,4,15,8
air_c73d319ffabf287a,hpg_e8f879fcbf993278,2017-02-11,3,3,21,6
air_c73d319ffabf287a,hpg_e8f879fcbf993278,2017-02-23,2,2,29,4
air_c73d319ffabf287a,hpg_e8f879fcbf993278,2017-02-24,10,7,22,17
air_c73d319ffabf287a,hpg_e8f879fcbf993278,2017-02-25,7,4,22,11
air_c73d319ffabf287a,hpg_e8f879fcbf993278,2017-03-03,9,2,27,11
air_c73d319ffabf287a,hpg_e8f879fcbf993278,2017-03-04,4,4,40,8
air_c73d319ffabf287a,hpg_e8f879fcbf993278,2017-03-07,2,2,28,4
air_c73d319ffabf287a,hpg_e8f879fcbf993278,2017-03-08,13,2,18,15
air_c73d319ffabf287a,hpg_e8f879fcbf993278,2017-03-10,14,6,31,20
air_c73d319ffabf287a,hpg_e8f879fcbf993278,2017-03-15,3,3,16,6
air_c73d319ffabf287a,hpg_e8f879fcbf993278,2017-03-16,2,2,13,4
air_c73d319ffabf287a,hpg_e8f879fcbf993278,2017-03-17,15,5,27,20
air_c73d319ffabf287a,hpg_e8f879fcbf993278,2017-03-22,2,2,6,4
air_c73d319ffabf287a,hpg_e8f879fcbf993278,2017-03-24,16,23,26,39
air_c73d319ffabf287a,hpg_e8f879fcbf993278,2017-03-25,2,7,43,9
air_c73d319ffabf287a,hpg_e8f879fcbf993278,2017-03-28,4,4,26,8
air_c73d319ffabf287a,hpg_e8f879fcbf993278,2017-04-01,4,4,24,8
air_c73d319ffabf287a,hpg_e8f879fcbf993278,2017-04-04,4,4,7,8
air_c73d319ffabf287a,hpg_e8f879fcbf993278,2017-04-07,2,2,5,4
air_c73d319ffabf287a,hpg_e8f879fcbf993278,2017-04-08,2,2,29,4
air_c73d319ffabf287a,hpg_e8f879fcbf993278,2017-04-14,4,4,10,8
air_c73d319ffabf287a,hpg_e8f879fcbf993278,2017-04-15,2,4,26,6
air_c73d319ffabf287a,hpg_e8f879fcbf993278,2017-04-18,7,4,12,11
air_04cae7c1bc9b2a0b,hpg_1803b7bed3a5927e,2016-10-27,4,4,12,8
air_04cae7c1bc9b2a0b,hpg_1803b7bed3a5927e,2016-10-28,23,3,37,26
air_04cae7c1bc9b2a0b,hpg_1803b7bed3a5927e,2016-10-29,26,10,34,36
air_04cae7c1bc9b2a0b,hpg_1803b7bed3a5927e,2016-10-30,7,7,26,14
air_04cae7c1bc9b2a0b,hpg_1803b7bed3a5927e,2016-10-31,13,3,27,16
air_04cae7c1bc9b2a0b,hpg_1803b7bed3a5927e,2016-11-01,8,5,16,13
air_04cae7c1bc9b2a0b,hpg_1803b7bed3a5927e,2016-11-02,19,12,28,31
air_04cae7c1bc9b2a0b,hpg_1803b7bed3a5927e,2016-11-04,25,12,31,37
air_04cae7c1bc9b2a0b,hpg_1803b7bed3a5927e,2016-11-05,26,11,34,37
air_04cae7c1bc9b2a0b,hpg_1803b7bed3a5927e,2016-11-06,12,6,33,18
air_04cae7c1bc9b2a0b,hpg_1803b7bed3a5927e,2016-11-09,11,7,19,18
air_04cae7c1bc9b2a0b,hpg_1803b7bed3a5927e,2016-11-10,7,3,18,10
air_04cae7c1bc9b2a0b,hpg_1803b7bed3a5927e,2016-11-12,37,10,48,47
air_04cae7c1bc9b2a0b,hpg_1803b7bed3a5927e,2016-11-13,11,11,27,22
air_04cae7c1bc9b2a0b,hpg_1803b7bed3a5927e,2016-11-15,4,4,20,8
air_04cae7c1bc9b2a0b,hpg_1803b7bed3a5927e,2016-11-17,24,7,29,31
air_04cae7c1bc9b2a0b,hpg_1803b7bed3a5927e,2016-11-18,21,19,31,40
air_04cae7c1bc9b2a0b,hpg_1803b7bed3a5927e,2016-11-19,34,13,40,47
air_04cae7c1bc9b2a0b,hpg_1803b7bed3a5927e,2016-11-20,22,10,31,32
air_04cae7c1bc9b2a0b,hpg_1803b7bed3a5927e,2016-11-22,6,7,10,13
air_04cae7c1bc9b2a0b,hpg_1803b7bed3a5927e,2016-11-24,5,5,13,10
air_04cae7c1bc9b2a0b,hpg_1803b7bed3a5927e,2016-11-25,28,7,40,35
air_04cae7c1bc9b2a0b,hpg_1803b7bed3a5927e,2016-11-26,24,9,44,33
air_04cae7c1bc9b2a0b,hpg_1803b7bed3a5927e,2016-11-29,6,8,25,14
air_04cae7c1bc9b2a0b,hpg_1803b7bed3a5927e,2016-12-02,22,12,30,34
air_04cae7c1bc9b2a0b,hpg_1803b7bed3a5927e,2016-12-03,30,4,45,34
air_04cae7c1bc9b2a0b,hpg_1803b7bed3a5927e,2016-12-07,15,5,19,20
air_04cae7c1bc9b2a0b,hpg_1803b7bed3a5927e,2016-12-09,19,12,24,31
air_04cae7c1bc9b2a0b,hpg_1803b7bed3a5927e,2016-12-10,37,12,42,49
air_04cae7c1bc9b2a0b,hpg_1803b7bed3a5927e,2016-12-13,16,9,24,25
air_04cae7c1bc9b2a0b,hpg_1803b7bed3a5927e,2016-12-15,14,9,31,23
air_04cae7c1bc9b2a0b,hpg_1803b7bed3a5927e,2016-12-16,23,26,31,49
air_04cae7c1bc9b2a0b,hpg_1803b7bed3a5927e,2016-12-17,36,14,59,50
air_04cae7c1bc9b2a0b,hpg_1803b7bed3a5927e,2016-12-18,4,3,25,7
air_04cae7c1bc9b2a0b,hpg_1803b7bed3a5927e,2016-12-20,12,2,15,14
air_04cae7c1bc9b2a0b,hpg_1803b7bed3a5927e,2016-12-21,10,8,26,18
air_04cae7c1bc9b2a0b,hpg_1803b7bed3a5927e,2016-12-22,42,20,36,62
air_04cae7c1bc9b2a0b,hpg_1803b7bed3a5927e,2016-12-23,23,12,44,35
air_04cae7c1bc9b2a0b,hpg_1803b7bed3a5927e,2016-12-24,24,6,38,30
air_04cae7c1bc9b2a0b,hpg_1803b7bed3a5927e,2016-12-25,3,3,21,6
air_04cae7c1bc9b2a0b,hpg_1803b7bed3a5927e,2016-12-26,42,18,37,60
air_04cae7c1bc9b2a0b,hpg_1803b7bed3a5927e,2016-12-28,38,14,35,52
air_04cae7c1bc9b2a0b,hpg_1803b7bed3a5927e,2016-12-29,52,24,62,76
air_04cae7c1bc9b2a0b,hpg_1803b7bed3a5927e,2016-12-30,48,16,66,64
air_04cae7c1bc9b2a0b,hpg_1803b7bed3a5927e,2017-01-01,19,7,27,26
air_04cae7c1bc9b2a0b,hpg_1803b7bed3a5927e,2017-01-02,31,9,30,40
air_04cae7c1bc9b2a0b,hpg_1803b7bed3a5927e,2017-01-03,19,5,39,24
air_04cae7c1bc9b2a0b,hpg_1803b7bed3a5927e,2017-01-04,7,6,19,13
air_04cae7c1bc9b2a0b,hpg_1803b7bed3a5927e,2017-01-06,21,11,33,32
air_04cae7c1bc9b2a0b,hpg_1803b7bed3a5927e,2017-01-07,25,26,33,51
air_04cae7c1bc9b2a0b,hpg_1803b7bed3a5927e,2017-01-12,4,4,12,8
air_04cae7c1bc9b2a0b,hpg_1803b7bed3a5927e,2017-01-13,28,15,37,43
air_04cae7c1bc9b2a0b,hpg_1803b7bed3a5927e,2017-01-14,17,9,32,26
air_04cae7c1bc9b2a0b,hpg_1803b7bed3a5927e,2017-01-15,6,4,12,10
air_04cae7c1bc9b2a0b,hpg_1803b7bed3a5927e,2017-01-18,21,15,16,36
air_04cae7c1bc9b2a0b,hpg_1803b7bed3a5927e,2017-01-19,9,7,36,16
air_04cae7c1bc9b2a0b,hpg_1803b7bed3a5927e,2017-01-20,26,10,37,36
air_04cae7c1bc9b2a0b,hpg_1803b7bed3a5927e,2017-01-21,34,11,46,45
air_04cae7c1bc9b2a0b,hpg_1803b7bed3a5927e,2017-01-22,6,4,15,10
air_04cae7c1bc9b2a0b,hpg_1803b7bed3a5927e,2017-01-23,26,2,31,28
air_04cae7c1bc9b2a0b,hpg_1803b7bed3a5927e,2017-01-25,4,4,21,8
air_04cae7c1bc9b2a0b,hpg_1803b7bed3a5927e,2017-01-26,11,9,8,20
air_04cae7c1bc9b2a0b,hpg_1803b7bed3a5927e,2017-01-27,33,15,46,48
air_04cae7c1bc9b2a0b,hpg_1803b7bed3a5927e,2017-01-28,36,16,45,52
air_04cae7c1bc9b2a0b,hpg_1803b7bed3a5927e,2017-01-30,9,3,16,12
air_04cae7c1bc9b2a0b,hpg_1803b7bed3a5927e,2017-01-31,14,10,27,24
air_04cae7c1bc9b2a0b,hpg_1803b7bed3a5927e,2017-02-01,7,7,31,14
air_04cae7c1bc9b2a0b,hpg_1803b7bed3a5927e,2017-02-03,13,4,11,17
air_04cae7c1bc9b2a0b,hpg_1803b7bed3a5927e,2017-02-04,37,11,56,48
air_04cae7c1bc9b2a0b,hpg_1803b7bed3a5927e,2017-02-05,14,6,33,20
air_04cae7c1bc9b2a0b,hpg_1803b7bed3a5927e,2017-02-06,7,7,12,14
air_04cae7c1bc9b2a0b,hpg_1803b7bed3a5927e,2017-02-10,29,4,42,33
air_04cae7c1bc9b2a0b,hpg_1803b7bed3a5927e,2017-02-11,38,21,53,59
air_04cae7c1bc9b2a0b,hpg_1803b7bed3a5927e,2017-02-12,6,4,23,10
air_04cae7c1bc9b2a0b,hpg_1803b7bed3a5927e,2017-02-13,18,15,15,33
air_04cae7c1bc9b2a0b,hpg_1803b7bed3a5927e,2017-02-17,13,5,32,18
air_04cae7c1bc9b2a0b,hpg_1803b7bed3a5927e,2017-02-18,21,16,30,37
air_04cae7c1bc9b2a0b,hpg_1803b7bed3a5927e,2017-02-20,6,2,15,8
air_04cae7c1bc9b2a0b,hpg_1803b7bed3a5927e,2017-02-21,2,2,19,4
air_04cae7c1bc9b2a0b,hpg_1803b7bed3a5927e,2017-02-22,6,2,23,8
air_04cae7c1bc9b2a0b,hpg_1803b7bed3a5927e,2017-02-24,28,18,32,46
air_04cae7c1bc9b2a0b,hpg_1803b7bed3a5927e,2017-02-25,36,18,52,54
air_04cae7c1bc9b2a0b,hpg_1803b7bed3a5927e,2017-02-26,16,6,17,22
air_04cae7c1bc9b2a0b,hpg_1803b7bed3a5927e,2017-02-27,7,3,27,10
air_04cae7c1bc9b2a0b,hpg_1803b7bed3a5927e,2017-03-02,4,4,8,8
air_04cae7c1bc9b2a0b,hpg_1803b7bed3a5927e,2017-03-03,15,5,27,20
air_04cae7c1bc9b2a0b,hpg_1803b7bed3a5927e,2017-03-04,36,8,51,44
air_04cae7c1bc9b2a0b,hpg_1803b7bed3a5927e,2017-03-05,19,5,19,24
air_04cae7c1bc9b2a0b,hpg_1803b7bed3a5927e,2017-03-08,13,7,17,20
air_04cae7c1bc9b2a0b,hpg_1803b7bed3a5927e,2017-03-09,6,5,9,11
air_04cae7c1bc9b2a0b,hpg_1803b7bed3a5927e,2017-03-10,9,9,21,18
air_04cae7c1bc9b2a0b,hpg_1803b7bed3a5927e,2017-03-11,30,3,42,33
air_04cae7c1bc9b2a0b,hpg_1803b7bed3a5927e,2017-03-12,10,8,23,18
air_04cae7c1bc9b2a0b,hpg_1803b7bed3a5927e,2017-03-16,9,9,19,18
air_04cae7c1bc9b2a0b,hpg_1803b7bed3a5927e,2017-03-17,13,7,30,20
air_04cae7c1bc9b2a0b,hpg_1803b7bed3a5927e,2017-03-18,23,18,39,41
air_04cae7c1bc9b2a0b,hpg_1803b7bed3a5927e,2017-03-20,7,7,19,14
air_04cae7c1bc9b2a0b,hpg_1803b7bed3a5927e,2017-03-21,13,13,15,26
air_04cae7c1bc9b2a0b,hpg_1803b7bed3a5927e,2017-03-22,9,5,20,14
air_04cae7c1bc9b2a0b,hpg_1803b7bed3a5927e,2017-03-24,34,6,42,40
air_04cae7c1bc9b2a0b,hpg_1803b7bed3a5927e,2017-03-25,37,9,44,46
air_04cae7c1bc9b2a0b,hpg_1803b7bed3a5927e,2017-03-26,6,2,19,8
air_04cae7c1bc9b2a0b,hpg_1803b7bed3a5927e,2017-03-31,25,5,32,30
air_04cae7c1bc9b2a0b,hpg_1803b7bed3a5927e,2017-04-01,36,18,48,54
air_04cae7c1bc9b2a0b,hpg_1803b7bed3a5927e,2017-04-02,2,2,8,4
air_04cae7c1bc9b2a0b,hpg_1803b7bed3a5927e,2017-04-03,19,11,21,30
air_04cae7c1bc9b2a0b,hpg_1803b7bed3a5927e,2017-04-05,4,4,8,8
air_04cae7c1bc9b2a0b,hpg_1803b7bed3a5927e,2017-04-07,29,14,33,43
air_04cae7c1bc9b2a0b,hpg_1803b7bed3a5927e,2017-04-08,23,11,34,34
air_04cae7c1bc9b2a0b,hpg_1803b7bed3a5927e,2017-04-12,3,3,20,6
air_04cae7c1bc9b2a0b,hpg_1803b7bed3a5927e,2017-04-14,51,6,54,57
air_04cae7c1bc9b2a0b,hpg_1803b7bed3a5927e,2017-04-15,15,10,22,25
air_04cae7c1bc9b2a0b,hpg_1803b7bed3a5927e,2017-04-17,2,2,2,4
air_04cae7c1bc9b2a0b,hpg_1803b7bed3a5927e,2017-04-19,14,2,18,16
air_04cae7c1bc9b2a0b,hpg_1803b7bed3a5927e,2017-04-20,5,2,16,7
air_04cae7c1bc9b2a0b,hpg_1803b7bed3a5927e,2017-04-21,14,4,27,18
air_04cae7c1bc9b2a0b,hpg_1803b7bed3a5927e,2017-04-22,16,6,40,22
air_7420042ff75f9aca,hpg_7459535472b27200,2017-01-23,3,3,33,6
air_7420042ff75f9aca,hpg_7459535472b27200,2017-01-24,10,5,27,15
air_7420042ff75f9aca,hpg_7459535472b27200,2017-01-25,5,7,20,12
air_7420042ff75f9aca,hpg_7459535472b27200,2017-01-26,18,3,44,21
air_7420042ff75f9aca,hpg_7459535472b27200,2017-01-27,16,2,40,18
air_7420042ff75f9aca,hpg_7459535472b27200,2017-01-28,11,14,35,25
air_7420042ff75f9aca,hpg_7459535472b27200,2017-02-02,11,6,36,17
air_7420042ff75f9aca,hpg_7459535472b27200,2017-02-08,4,2,11,6
air_7420042ff75f9aca,hpg_7459535472b27200,2017-02-09,10,25,35,35
air_7420042ff75f9aca,hpg_7459535472b27200,2017-02-10,18,11,34,29
air_7420042ff75f9aca,hpg_7459535472b27200,2017-02-15,9,9,21,18
air_7420042ff75f9aca,hpg_7459535472b27200,2017-02-16,31,37,37,68
air_7420042ff75f9aca,hpg_7459535472b27200,2017-02-17,28,2,30,30
air_7420042ff75f9aca,hpg_7459535472b27200,2017-02-18,14,8,31,22
air_7420042ff75f9aca,hpg_7459535472b27200,2017-02-19,10,4,28,14
air_7420042ff75f9aca,hpg_7459535472b27200,2017-02-22,13,14,16,27
air_7420042ff75f9aca,hpg_7459535472b27200,2017-02-24,4,10,20,14
air_7420042ff75f9aca,hpg_7459535472b27200,2017-02-25,6,24,26,30
air_7420042ff75f9aca,hpg_7459535472b27200,2017-02-28,11,5,17,16
air_7420042ff75f9aca,hpg_7459535472b27200,2017-03-03,18,8,18,26
air_7420042ff75f9aca,hpg_7459535472b27200,2017-03-04,32,23,18,55
air_7420042ff75f9aca,hpg_7459535472b27200,2017-03-05,12,5,22,17
air_7420042ff75f9aca,hpg_7459535472b27200,2017-03-11,25,22,29,47
air_7420042ff75f9aca,hpg_7459535472b27200,2017-03-12,4,4,22,8
air_7420042ff75f9aca,hpg_7459535472b27200,2017-03-15,18,28,29,46
air_7420042ff75f9aca,hpg_7459535472b27200,2017-03-16,11,13,24,24
air_7420042ff75f9aca,hpg_7459535472b27200,2017-03-17,20,9,29,29
air_7420042ff75f9aca,hpg_7459535472b27200,2017-03-18,19,14,32,33
air_7420042ff75f9aca,hpg_7459535472b27200,2017-03-19,19,13,61,32
air_7420042ff75f9aca,hpg_7459535472b27200,2017-03-20,16,2,40,18
air_7420042ff75f9aca,hpg_7459535472b27200,2017-03-22,17,9,36,26
air_7420042ff75f9aca,hpg_7459535472b27200,2017-03-23,27,28,47,55
air_7420042ff75f9aca,hpg_7459535472b27200,2017-03-24,17,6,53,23
air_7420042ff75f9aca,hpg_7459535472b27200,2017-03-25,25,19,52,44
air_7420042ff75f9aca,hpg_7459535472b27200,2017-03-26,9,5,58,14
air_7420042ff75f9aca,hpg_7459535472b27200,2017-03-27,12,6,42,18
air_7420042ff75f9aca,hpg_7459535472b27200,2017-03-28,18,2,51,20
air_7420042ff75f9aca,hpg_7459535472b27200,2017-03-29,15,25,45,40
air_7420042ff75f9aca,hpg_7459535472b27200,2017-03-30,2,2,16,4
air_7420042ff75f9aca,hpg_7459535472b27200,2017-03-31,21,12,54,33
air_7420042ff75f9aca,hpg_7459535472b27200,2017-04-01,30,8,67,38
air_7420042ff75f9aca,hpg_7459535472b27200,2017-04-02,9,2,53,11
air_7420042ff75f9aca,hpg_7459535472b27200,2017-04-03,28,4,37,32
air_7420042ff75f9aca,hpg_7459535472b27200,2017-04-04,3,30,29,33
air_7420042ff75f9aca,hpg_7459535472b27200,2017-04-07,13,12,44,25
air_7420042ff75f9aca,hpg_7459535472b27200,2017-04-08,23,3,45,26
air_7420042ff75f9aca,hpg_7459535472b27200,2017-04-09,4,2,56,6
air_7420042ff75f9aca,hpg_7459535472b27200,2017-04-11,2,2,4,4
air_7420042ff75f9aca,hpg_7459535472b27200,2017-04-12,6,6,32,12
air_7420042ff75f9aca,hpg_7459535472b27200,2017-04-13,10,3,41,13
air_7420042ff75f9aca,hpg_7459535472b27200,2017-04-14,16,8,40,24
air_7420042ff75f9aca,hpg_7459535472b27200,2017-04-16,8,2,41,10
air_7420042ff75f9aca,hpg_7459535472b27200,2017-04-19,6,6,29,12
air_7420042ff75f9aca,hpg_7459535472b27200,2017-04-21,21,33,38,54
air_7420042ff75f9aca,hpg_7459535472b27200,2017-04-22,19,19,52,38
air_4c727b55acdee495,hpg_26d20b9f926ff5e9,2016-10-28,2,2,36,4
air_4c727b55acdee495,hpg_26d20b9f926ff5e9,2016-10-29,10,6,16,16
air_4c727b55acdee495,hpg_26d20b9f926ff5e9,2016-10-30,4,2,23,6
air_4c727b55acdee495,hpg_26d20b9f926ff5e9,2016-10-31,7,1,11,8
air_4c727b55acdee495,hpg_26d20b9f926ff5e9,2016-11-03,9,4,22,13
air_4c727b55acdee495,hpg_26d20b9f926ff5e9,2016-11-06,19,13,23,32
air_4c727b55acdee495,hpg_26d20b9f926ff5e9,2016-11-07,12,10,17,22
air_4c727b55acdee495,hpg_26d20b9f926ff5e9,2016-11-08,12,4,16,16
air_4c727b55acdee495,hpg_26d20b9f926ff5e9,2016-11-09,7,7,3,14
air_4c727b55acdee495,hpg_26d20b9f926ff5e9,2016-11-11,5,3,8,8
air_4c727b55acdee495,hpg_26d20b9f926ff5e9,2016-11-13,19,2,37,21
air_4c727b55acdee495,hpg_26d20b9f926ff5e9,2016-11-15,13,9,21,22
air_4c727b55acdee495,hpg_26d20b9f926ff5e9,2016-11-16,10,5,12,15
air_4c727b55acdee495,hpg_26d20b9f926ff5e9,2016-11-17,2,2,16,4
air_4c727b55acdee495,hpg_26d20b9f926ff5e9,2016-11-18,12,2,22,14
air_4c727b55acdee495,hpg_26d20b9f926ff5e9,2016-11-19,14,6,22,20
air_4c727b55acdee495,hpg_26d20b9f926ff5e9,2016-11-22,10,3,15,13
air_4c727b55acdee495,hpg_26d20b9f926ff5e9,2016-11-23,13,3,23,16
air_4c727b55acdee495,hpg_26d20b9f926ff5e9,2016-11-24,9,2,22,11
air_4c727b55acdee495,hpg_26d20b9f926ff5e9,2016-11-25,6,4,10,10
air_4c727b55acdee495,hpg_26d20b9f926ff5e9,2016-11-26,7,3,16,10
air_4c727b55acdee495,hpg_26d20b9f926ff5e9,2016-11-27,15,8,17,23
air_4c727b55acdee495,hpg_26d20b9f926ff5e9,2016-11-28,8,4,11,12
air_4c727b55acdee495,hpg_26d20b9f926ff5e9,2016-11-29,4,2,15,6
air_4c727b55acdee495,hpg_26d20b9f926ff5e9,2016-12-01,12,7,22,19
air_4c727b55acdee495,hpg_26d20b9f926ff5e9,2016-12-02,4,2,8,6
air_4c727b55acdee495,hpg_26d20b9f926ff5e9,2016-12-05,13,2,16,15
air_4c727b55acdee495,hpg_26d20b9f926ff5e9,2016-12-06,10,5,17,15
air_4c727b55acdee495,hpg_26d20b9f926ff5e9,2016-12-07,4,2,15,6
air_4c727b55acdee495,hpg_26d20b9f926ff5e9,2016-12-08,7,4,14,11
air_4c727b55acdee495,hpg_26d20b9f926ff5e9,2016-12-09,13,10,25,23
air_4c727b55acdee495,hpg_26d20b9f926ff5e9,2016-12-10,11,4,21,15
air_4c727b55acdee495,hpg_26d20b9f926ff5e9,2016-12-11,7,4,14,11
air_4c727b55acdee495,hpg_26d20b9f926ff5e9,2016-12-12,6,4,14,10
air_4c727b55acdee495,hpg_26d20b9f926ff5e9,2016-12-14,6,4,14,10
air_4c727b55acdee495,hpg_26d20b9f926ff5e9,2016-12-17,9,5,19,14
air_4c727b55acdee495,hpg_26d20b9f926ff5e9,2016-12-19,7,7,9,14
air_4c727b55acdee495,hpg_26d20b9f926ff5e9,2016-12-21,7,3,23,10
air_4c727b55acdee495,hpg_26d20b9f926ff5e9,2016-12-22,5,3,20,8
air_4c727b55acdee495,hpg_26d20b9f926ff5e9,2016-12-23,13,9,7,22
air_4c727b55acdee495,hpg_26d20b9f926ff5e9,2016-12-24,8,4,26,12
air_4c727b55acdee495,hpg_26d20b9f926ff5e9,2016-12-25,6,2,8,8
air_4c727b55acdee495,hpg_26d20b9f926ff5e9,2016-12-26,8,6,12,14
air_4c727b55acdee495,hpg_26d20b9f926ff5e9,2016-12-27,9,7,9,16
air_4c727b55acdee495,hpg_26d20b9f926ff5e9,2016-12-29,14,7,14,21
air_4c727b55acdee495,hpg_26d20b9f926ff5e9,2017-01-07,9,3,11,12
air_4c727b55acdee495,hpg_26d20b9f926ff5e9,2017-01-09,9,3,22,12
air_4c727b55acdee495,hpg_26d20b9f926ff5e9,2017-01-11,6,5,24,11
air_4c727b55acdee495,hpg_26d20b9f926ff5e9,2017-01-12,6,4,13,10
air_4c727b55acdee495,hpg_26d20b9f926ff5e9,2017-01-15,7,2,9,9
air_4c727b55acdee495,hpg_26d20b9f926ff5e9,2017-01-17,4,4,16,8
air_4c727b55acdee495,hpg_26d20b9f926ff5e9,2017-01-21,6,2,17,8
air_4c727b55acdee495,hpg_26d20b9f926ff5e9,2017-01-22,25,18,29,43
air_4c727b55acdee495,hpg_26d20b9f926ff5e9,2017-01-23,5,5,5,10
air_4c727b55acdee495,hpg_26d20b9f926ff5e9,2017-01-25,9,2,26,11
air_4c727b55acdee495,hpg_26d20b9f926ff5e9,2017-01-26,12,8,18,20
air_4c727b55acdee495,hpg_26d20b9f926ff5e9,2017-01-31,6,4,16,10
air_4c727b55acdee495,hpg_26d20b9f926ff5e9,2017-02-01,10,5,8,15
air_4c727b55acdee495,hpg_26d20b9f926ff5e9,2017-02-04,9,2,22,11
air_4c727b55acdee495,hpg_26d20b9f926ff5e9,2017-02-05,12,9,24,21
air_4c727b55acdee495,hpg_26d20b9f926ff5e9,2017-02-07,14,8,20,22
air_4c727b55acdee495,hpg_26d20b9f926ff5e9,2017-02-10,16,2,21,18
air_4c727b55acdee495,hpg_26d20b9f926ff5e9,2017-02-11,10,2,15,12
air_4c727b55acdee495,hpg_26d20b9f926ff5e9,2017-02-12,22,11,28,33
air_4c727b55acdee495,hpg_26d20b9f926ff5e9,2017-02-13,2,2,11,4
air_4c727b55acdee495,hpg_26d20b9f926ff5e9,2017-02-15,10,4,14,14
air_4c727b55acdee495,hpg_26d20b9f926ff5e9,2017-02-17,17,8,24,25
air_4c727b55acdee495,hpg_26d20b9f926ff5e9,2017-02-18,4,2,10,6
air_4c727b55acdee495,hpg_26d20b9f926ff5e9,2017-02-19,2,2,11,4
air_4c727b55acdee495,hpg_26d20b9f926ff5e9,2017-02-20,7,4,16,11
air_4c727b55acdee495,hpg_26d20b9f926ff5e9,2017-02-21,9,3,14,12
air_4c727b55acdee495,hpg_26d20b9f926ff5e9,2017-02-22,2,2,8,4
air_4c727b55acdee495,hpg_26d20b9f926ff5e9,2017-02-23,10,6,20,16
air_4c727b55acdee495,hpg_26d20b9f926ff5e9,2017-02-24,4,4,20,8
air_4c727b55acdee495,hpg_26d20b9f926ff5e9,2017-02-25,8,5,24,13
air_4c727b55acdee495,hpg_26d20b9f926ff5e9,2017-02-28,7,2,24,9
air_4c727b55acdee495,hpg_26d20b9f926ff5e9,2017-03-01,16,9,27,25
air_4c727b55acdee495,hpg_26d20b9f926ff5e9,2017-03-03,13,5,21,18
air_4c727b55acdee495,hpg_26d20b9f926ff5e9,2017-03-04,7,3,12,10
air_4c727b55acdee495,hpg_26d20b9f926ff5e9,2017-03-05,11,4,32,15
air_4c727b55acdee495,hpg_26d20b9f926ff5e9,2017-03-06,8,3,14,11
air_4c727b55acdee495,hpg_26d20b9f926ff5e9,2017-03-07,8,2,22,10
air_4c727b55acdee495,hpg_26d20b9f926ff5e9,2017-03-09,20,6,20,26
air_4c727b55acdee495,hpg_26d20b9f926ff5e9,2017-03-11,6,11,19,17
air_4c727b55acdee495,hpg_26d20b9f926ff5e9,2017-03-12,14,2,19,16
air_4c727b55acdee495,hpg_26d20b9f926ff5e9,2017-03-13,5,5,9,10
air_4c727b55acdee495,hpg_26d20b9f926ff5e9,2017-03-14,19,13,24,32
air_4c727b55acdee495,hpg_26d20b9f926ff5e9,2017-03-15,14,8,26,22
air_4c727b55acdee495,hpg_26d20b9f926ff5e9,2017-03-16,14,2,20,16
air_4c727b55acdee495,hpg_26d20b9f926ff5e9,2017-03-17,23,11,25,34
air_4c727b55acdee495,hpg_26d20b9f926ff5e9,2017-03-18,9,2,20,11
air_4c727b55acdee495,hpg_26d20b9f926ff5e9,2017-03-19,10,5,20,15
air_4c727b55acdee495,hpg_26d20b9f926ff5e9,2017-03-20,10,7,19,17
air_4c727b55acdee495,hpg_26d20b9f926ff5e9,2017-03-21,6,3,6,9
air_4c727b55acdee495,hpg_26d20b9f926ff5e9,2017-03-22,14,10,17,24
air_4c727b55acdee495,hpg_26d20b9f926ff5e9,2017-03-24,13,5,13,18
air_4c727b55acdee495,hpg_26d20b9f926ff5e9,2017-03-27,10,6,16,16
air_4c727b55acdee495,hpg_26d20b9f926ff5e9,2017-03-28,4,2,12,6
air_4c727b55acdee495,hpg_26d20b9f926ff5e9,2017-03-29,12,6,24,18
air_4c727b55acdee495,hpg_26d20b9f926ff5e9,2017-03-30,13,4,28,17
air_4c727b55acdee495,hpg_26d20b9f926ff5e9,2017-03-31,10,2,26,12
air_4c727b55acdee495,hpg_26d20b9f926ff5e9,2017-04-02,11,6,20,17
air_4c727b55acdee495,hpg_26d20b9f926ff5e9,2017-04-03,4,2,8,6
air_4c727b55acdee495,hpg_26d20b9f926ff5e9,2017-04-04,3,2,3,5
air_4c727b55acdee495,hpg_26d20b9f926ff5e9,2017-04-05,2,2,20,4
air_4c727b55acdee495,hpg_26d20b9f926ff5e9,2017-04-07,19,9,22,28
air_4c727b55acdee495,hpg_26d20b9f926ff5e9,2017-04-08,17,6,25,23
air_4c727b55acdee495,hpg_26d20b9f926ff5e9,2017-04-09,5,5,17,10
air_4c727b55acdee495,hpg_26d20b9f926ff5e9,2017-04-11,10,10,14,20
air_4c727b55acdee495,hpg_26d20b9f926ff5e9,2017-04-12,13,5,20,18
air_4c727b55acdee495,hpg_26d20b9f926ff5e9,2017-04-14,10,4,16,14
air_4c727b55acdee495,hpg_26d20b9f926ff5e9,2017-04-15,14,6,16,20
air_4c727b55acdee495,hpg_26d20b9f926ff5e9,2017-04-16,16,13,18,29
air_4c727b55acdee495,hpg_26d20b9f926ff5e9,2017-04-17,7,4,8,11
air_4c727b55acdee495,hpg_26d20b9f926ff5e9,2017-04-18,4,2,14,6
air_4c727b55acdee495,hpg_26d20b9f926ff5e9,2017-04-20,13,8,23,21
air_4c727b55acdee495,hpg_26d20b9f926ff5e9,2017-04-22,5,5,20,10
air_cfcc94797d2b5d3d,hpg_dad8da3ff443ba1a,2016-11-04,11,11,6,22
air_cfcc94797d2b5d3d,hpg_dad8da3ff443ba1a,2016-11-05,3,3,21,6
air_cfcc94797d2b5d3d,hpg_dad8da3ff443ba1a,2016-11-07,2,2,9,4
air_cfcc94797d2b5d3d,hpg_dad8da3ff443ba1a,2016-11-19,17,7,27,24
air_cfcc94797d2b5d3d,hpg_dad8da3ff443ba1a,2016-11-22,6,6,16,12
air_cfcc94797d2b5d3d,hpg_dad8da3ff443ba1a,2016-11-26,33,23,46,56
air_cfcc94797d2b5d3d,hpg_dad8da3ff443ba1a,2016-12-03,21,61,80,82
air_cfcc94797d2b5d3d,hpg_dad8da3ff443ba1a,2016-12-10,11,3,17,14
air_cfcc94797d2b5d3d,hpg_dad8da3ff443ba1a,2016-12-11,4,4,20,8
air_cfcc94797d2b5d3d,hpg_dad8da3ff443ba1a,2016-12-16,12,6,16,18
air_cfcc94797d2b5d3d,hpg_dad8da3ff443ba1a,2016-12-17,27,15,33,42
air_cfcc94797d2b5d3d,hpg_dad8da3ff443ba1a,2016-12-22,10,6,13,16
air_cfcc94797d2b5d3d,hpg_dad8da3ff443ba1a,2016-12-24,4,2,10,6
air_cfcc94797d2b5d3d,hpg_dad8da3ff443ba1a,2016-12-29,24,6,39,30
air_cfcc94797d2b5d3d,hpg_dad8da3ff443ba1a,2016-12-30,50,4,51,54
air_cfcc94797d2b5d3d,hpg_dad8da3ff443ba1a,2016-12-31,21,20,30,41
air_cfcc94797d2b5d3d,hpg_dad8da3ff443ba1a,2017-01-01,18,9,55,27
air_cfcc94797d2b5d3d,hpg_dad8da3ff443ba1a,2017-01-02,25,9,40,34
air_cfcc94797d2b5d3d,hpg_dad8da3ff443ba1a,2017-01-07,41,13,49,54
air_cfcc94797d2b5d3d,hpg_dad8da3ff443ba1a,2017-01-14,33,10,41,43
air_cfcc94797d2b5d3d,hpg_dad8da3ff443ba1a,2017-01-27,18,9,18,27
air_cfcc94797d2b5d3d,hpg_dad8da3ff443ba1a,2017-01-28,33,21,39,54
air_cfcc94797d2b5d3d,hpg_dad8da3ff443ba1a,2017-02-03,22,2,61,24
air_cfcc94797d2b5d3d,hpg_dad8da3ff443ba1a,2017-02-04,7,2,27,9
air_cfcc94797d2b5d3d,hpg_dad8da3ff443ba1a,2017-02-16,12,6,14,18
air_cfcc94797d2b5d3d,hpg_dad8da3ff443ba1a,2017-02-20,5,5,7,10
air_cfcc94797d2b5d3d,hpg_dad8da3ff443ba1a,2017-02-24,8,4,10,12
air_cfcc94797d2b5d3d,hpg_dad8da3ff443ba1a,2017-02-25,16,8,33,24
air_cfcc94797d2b5d3d,hpg_dad8da3ff443ba1a,2017-02-26,16,2,25,18
air_cfcc94797d2b5d3d,hpg_dad8da3ff443ba1a,2017-03-04,49,3,55,52
air_cfcc94797d2b5d3d,hpg_dad8da3ff443ba1a,2017-03-11,25,15,35,40
air_cfcc94797d2b5d3d,hpg_dad8da3ff443ba1a,2017-03-18,44,18,47,62
air_cfcc94797d2b5d3d,hpg_dad8da3ff443ba1a,2017-03-19,43,6,41,49
air_cfcc94797d2b5d3d,hpg_dad8da3ff443ba1a,2017-03-20,2,3,16,5
air_cfcc94797d2b5d3d,hpg_dad8da3ff443ba1a,2017-03-22,3,3,14,6
air_cfcc94797d2b5d3d,hpg_dad8da3ff443ba1a,2017-04-03,2,2,4,4
air_cfcc94797d2b5d3d,hpg_dad8da3ff443ba1a,2017-04-19,6,6,16,12
air_cfcc94797d2b5d3d,hpg_dad8da3ff443ba1a,2017-04-22,29,8,28,37
air_f96765e800907c77,hpg_265bd3fe806f8b6e,2016-01-08,8,8,39,16
air_f96765e800907c77,hpg_265bd3fe806f8b6e,2016-01-09,4,8,30,12
air_f96765e800907c77,hpg_265bd3fe806f8b6e,2016-01-15,4,4,78,8
air_f96765e800907c77,hpg_265bd3fe806f8b6e,2016-03-05,2,2,19,4
air_f96765e800907c77,hpg_265bd3fe806f8b6e,2016-04-20,2,2,75,4
air_f96765e800907c77,hpg_265bd3fe806f8b6e,2016-05-07,7,7,10,14
air_f96765e800907c77,hpg_265bd3fe806f8b6e,2016-10-27,8,10,21,18
air_f96765e800907c77,hpg_265bd3fe806f8b6e,2016-11-12,2,2,12,4
air_f96765e800907c77,hpg_265bd3fe806f8b6e,2017-04-13,2,2,13,4
air_f96765e800907c77,hpg_265bd3fe806f8b6e,2017-04-14,28,11,75,39
air_54d6c25d33f5260e,hpg_62b71ee3f3c120c4,2016-11-03,2,2,14,4
air_54d6c25d33f5260e,hpg_62b71ee3f3c120c4,2017-04-09,2,2,8,4
air_54d6c25d33f5260e,hpg_62b71ee3f3c120c4,2017-04-10,2,4,41,6
air_54d6c25d33f5260e,hpg_62b71ee3f3c120c4,2017-04-14,4,6,62,10
air_54d6c25d33f5260e,hpg_62b71ee3f3c120c4,2017-04-15,2,4,26,6
air_1033310359ceeac1,hpg_8072ff2fb418e273,2016-04-16,4,2,37,6
air_1033310359ceeac1,hpg_8072ff2fb418e273,2016-04-19,6,4,26,10
air_1033310359ceeac1,hpg_8072ff2fb418e273,2016-04-20,20,6,25,26
air_1033310359ceeac1,hpg_8072ff2fb418e273,2016-04-23,6,2,41,8
air_1033310359ceeac1,hpg_8072ff2fb418e273,2016-04-30,10,8,37,18
air_1033310359ceeac1,hpg_8072ff2fb418e273,2016-05-04,2,2,26,4
air_1033310359ceeac1,hpg_8072ff2fb418e273,2016-05-06,2,2,8,4
air_1033310359ceeac1,hpg_8072ff2fb418e273,2016-10-27,2,2,11,4
air_1033310359ceeac1,hpg_8072ff2fb418e273,2016-10-28,4,7,8,11
air_1033310359ceeac1,hpg_8072ff2fb418e273,2016-11-04,9,9,24,18
air_1033310359ceeac1,hpg_8072ff2fb418e273,2016-11-17,2,2,4,4
air_1033310359ceeac1,hpg_8072ff2fb418e273,2016-11-21,4,2,10,6
air_1033310359ceeac1,hpg_8072ff2fb418e273,2016-11-25,5,4,21,9
air_1033310359ceeac1,hpg_8072ff2fb418e273,2016-12-06,17,6,21,23
air_1033310359ceeac1,hpg_8072ff2fb418e273,2016-12-09,10,4,26,14
air_1033310359ceeac1,hpg_8072ff2fb418e273,2016-12-10,27,10,20,37
air_1033310359ceeac1,hpg_8072ff2fb418e273,2016-12-13,17,3,20,20
air_1033310359ceeac1,hpg_8072ff2fb418e273,2016-12-14,19,3,21,22
air_1033310359ceeac1,hpg_8072ff2fb418e273,2016-12-15,9,10,27,19
air_1033310359ceeac1,hpg_8072ff2fb418e273,2016-12-16,16,10,28,26
air_1033310359ceeac1,hpg_8072ff2fb418e273,2016-12-17,14,2,27,16
air_1033310359ceeac1,hpg_8072ff2fb418e273,2016-12-19,7,11,13,18
air_1033310359ceeac1,hpg_8072ff2fb418e273,2016-12-21,31,30,38,61
air_1033310359ceeac1,hpg_8072ff2fb418e273,2016-12-22,29,4,55,33
air_1033310359ceeac1,hpg_8072ff2fb418e273,2016-12-26,20,7,9,27
air_1033310359ceeac1,hpg_8072ff2fb418e273,2016-12-27,20,2,27,22
air_1033310359ceeac1,hpg_8072ff2fb418e273,2016-12-28,13,4,55,17
air_1033310359ceeac1,hpg_8072ff2fb418e273,2016-12-30,23,2,39,25
air_1033310359ceeac1,hpg_8072ff2fb418e273,2016-12-31,14,6,32,20
air_1033310359ceeac1,hpg_8072ff2fb418e273,2017-01-05,2,2,47,4
air_1033310359ceeac1,hpg_8072ff2fb418e273,2017-01-12,2,2,4,4
air_1033310359ceeac1,hpg_8072ff2fb418e273,2017-01-13,18,6,18,24
air_1033310359ceeac1,hpg_8072ff2fb418e273,2017-01-15,14,3,9,17
air_1033310359ceeac1,hpg_8072ff2fb418e273,2017-01-23,8,8,4,16
air_1033310359ceeac1,hpg_8072ff2fb418e273,2017-01-25,25,4,9,29
air_1033310359ceeac1,hpg_8072ff2fb418e273,2017-02-03,17,2,17,19
air_1033310359ceeac1,hpg_8072ff2fb418e273,2017-02-09,6,2,10,8
air_1033310359ceeac1,hpg_8072ff2fb418e273,2017-02-11,19,2,26,21
air_1033310359ceeac1,hpg_8072ff2fb418e273,2017-02-16,15,10,30,25
air_1033310359ceeac1,hpg_8072ff2fb418e273,2017-02-18,8,2,13,10
air_1033310359ceeac1,hpg_8072ff2fb418e273,2017-02-21,4,2,4,6
air_1033310359ceeac1,hpg_8072ff2fb418e273,2017-02-25,11,2,31,13
air_1033310359ceeac1,hpg_8072ff2fb418e273,2017-02-26,12,2,30,14
air_1033310359ceeac1,hpg_8072ff2fb418e273,2017-03-01,8,4,32,12
air_1033310359ceeac1,hpg_8072ff2fb418e273,2017-03-09,6,22,8,28
air_1033310359ceeac1,hpg_8072ff2fb418e273,2017-03-11,16,2,18,18
air_1033310359ceeac1,hpg_8072ff2fb418e273,2017-03-14,16,2,6,18
air_1033310359ceeac1,hpg_8072ff2fb418e273,2017-03-15,15,4,22,19
air_1033310359ceeac1,hpg_8072ff2fb418e273,2017-03-19,11,4,27,15
air_1033310359ceeac1,hpg_8072ff2fb418e273,2017-03-22,17,4,25,21
air_1033310359ceeac1,hpg_8072ff2fb418e273,2017-03-24,21,3,39,24
air_1033310359ceeac1,hpg_8072ff2fb418e273,2017-03-28,11,7,18,18
air_1033310359ceeac1,hpg_8072ff2fb418e273,2017-04-01,5,3,35,8
air_1033310359ceeac1,hpg_8072ff2fb418e273,2017-04-05,19,2,24,21
air_1033310359ceeac1,hpg_8072ff2fb418e273,2017-04-06,10,2,8,12
air_1033310359ceeac1,hpg_8072ff2fb418e273,2017-04-07,4,4,37,8
air_1033310359ceeac1,hpg_8072ff2fb418e273,2017-04-09,2,2,10,4
air_1033310359ceeac1,hpg_8072ff2fb418e273,2017-04-11,24,8,26,32
air_25c583983246b7b0,hpg_66733016f2ac9ee8,2016-11-05,3,3,24,6
air_25c583983246b7b0,hpg_66733016f2ac9ee8,2016-11-09,4,4,21,8
air_25c583983246b7b0,hpg_66733016f2ac9ee8,2016-11-29,4,4,24,8
air_25c583983246b7b0,hpg_66733016f2ac9ee8,2016-12-01,8,8,12,16
air_25c583983246b7b0,hpg_66733016f2ac9ee8,2016-12-08,23,23,36,46
air_25c583983246b7b0,hpg_66733016f2ac9ee8,2016-12-09,46,30,49,76
air_25c583983246b7b0,hpg_66733016f2ac9ee8,2016-12-13,4,4,12,8
air_25c583983246b7b0,hpg_66733016f2ac9ee8,2016-12-14,13,3,10,16
air_25c583983246b7b0,hpg_66733016f2ac9ee8,2016-12-16,22,22,45,44
air_25c583983246b7b0,hpg_66733016f2ac9ee8,2016-12-17,5,8,36,13
air_25c583983246b7b0,hpg_66733016f2ac9ee8,2016-12-22,7,2,38,9
air_25c583983246b7b0,hpg_66733016f2ac9ee8,2016-12-24,7,5,29,12
air_25c583983246b7b0,hpg_66733016f2ac9ee8,2016-12-26,2,2,12,4
air_25c583983246b7b0,hpg_66733016f2ac9ee8,2016-12-27,6,4,28,10
air_25c583983246b7b0,hpg_66733016f2ac9ee8,2016-12-29,3,3,96,6
air_25c583983246b7b0,hpg_66733016f2ac9ee8,2017-01-04,19,19,59,38
air_25c583983246b7b0,hpg_66733016f2ac9ee8,2017-01-05,4,4,15,8
air_25c583983246b7b0,hpg_66733016f2ac9ee8,2017-01-13,3,5,26,8
air_25c583983246b7b0,hpg_66733016f2ac9ee8,2017-01-14,9,9,34,18
air_25c583983246b7b0,hpg_66733016f2ac9ee8,2017-01-21,10,3,49,13
air_25c583983246b7b0,hpg_66733016f2ac9ee8,2017-01-23,32,2,35,34
air_25c583983246b7b0,hpg_66733016f2ac9ee8,2017-01-27,3,3,38,6
air_25c583983246b7b0,hpg_66733016f2ac9ee8,2017-01-28,2,2,35,4
air_e270aff84ac7e4c8,hpg_8d472b917afb2cd9,2016-04-15,11,3,20,14
air_e270aff84ac7e4c8,hpg_8d472b917afb2cd9,2016-04-16,10,20,35,30
air_e270aff84ac7e4c8,hpg_8d472b917afb2cd9,2016-06-26,7,7,24,14
air_e270aff84ac7e4c8,hpg_8d472b917afb2cd9,2016-07-01,4,4,17,8
air_e270aff84ac7e4c8,hpg_8d472b917afb2cd9,2016-07-06,10,6,18,16
air_e270aff84ac7e4c8,hpg_8d472b917afb2cd9,2016-10-29,12,14,32,26
air_e270aff84ac7e4c8,hpg_8d472b917afb2cd9,2016-11-10,3,3,7,6
air_e270aff84ac7e4c8,hpg_8d472b917afb2cd9,2016-11-26,16,7,45,23
air_e270aff84ac7e4c8,hpg_8d472b917afb2cd9,2016-11-29,10,10,21,20
air_e270aff84ac7e4c8,hpg_8d472b917afb2cd9,2016-12-01,18,6,27,24
air_e270aff84ac7e4c8,hpg_8d472b917afb2cd9,2016-12-03,11,1,50,12
air_e270aff84ac7e4c8,hpg_8d472b917afb2cd9,2016-12-08,6,6,35,12
air_e270aff84ac7e4c8,hpg_8d472b917afb2cd9,2016-12-09,21,25,27,46
air_e270aff84ac7e4c8,hpg_8d472b917afb2cd9,2016-12-16,16,15,24,31
air_e270aff84ac7e4c8,hpg_8d472b917afb2cd9,2016-12-21,18,10,21,28
air_e270aff84ac7e4c8,hpg_8d472b917afb2cd9,2016-12-22,19,2,24,21
air_e270aff84ac7e4c8,hpg_8d472b917afb2cd9,2017-01-03,12,2,31,14
air_e270aff84ac7e4c8,hpg_8d472b917afb2cd9,2017-01-07,16,7,27,23
air_e270aff84ac7e4c8,hpg_8d472b917afb2cd9,2017-01-08,2,2,24,4
air_e270aff84ac7e4c8,hpg_8d472b917afb2cd9,2017-01-28,17,9,38,26
air_e270aff84ac7e4c8,hpg_8d472b917afb2cd9,2017-01-31,31,13,40,44
air_e270aff84ac7e4c8,hpg_8d472b917afb2cd9,2017-02-03,3,3,24,6
air_e270aff84ac7e4c8,hpg_8d472b917afb2cd9,2017-02-07,12,12,29,24
air_e270aff84ac7e4c8,hpg_8d472b917afb2cd9,2017-02-22,15,15,41,30
air_e270aff84ac7e4c8,hpg_8d472b917afb2cd9,2017-02-24,4,4,24,8
air_e270aff84ac7e4c8,hpg_8d472b917afb2cd9,2017-02-25,4,4,23,8
air_e270aff84ac7e4c8,hpg_8d472b917afb2cd9,2017-02-28,2,2,20,4
air_e270aff84ac7e4c8,hpg_8d472b917afb2cd9,2017-03-01,3,3,19,6
air_e270aff84ac7e4c8,hpg_8d472b917afb2cd9,2017-03-15,7,7,28,14
air_e270aff84ac7e4c8,hpg_8d472b917afb2cd9,2017-03-25,21,8,34,29
air_e270aff84ac7e4c8,hpg_8d472b917afb2cd9,2017-03-27,3,3,21,6
air_e270aff84ac7e4c8,hpg_8d472b917afb2cd9,2017-04-07,8,8,23,16
air_e270aff84ac7e4c8,hpg_8d472b917afb2cd9,2017-04-08,2,2,25,4
air_e270aff84ac7e4c8,hpg_8d472b917afb2cd9,2017-04-14,13,2,59,15
air_e270aff84ac7e4c8,hpg_8d472b917afb2cd9,2017-04-19,13,3,18,16
air_e270aff84ac7e4c8,hpg_8d472b917afb2cd9,2017-04-22,19,3,39,22
air_db1233ad855b34d5,hpg_3ebbe4996edd55d5,2016-10-28,9,2,32,11
air_db1233ad855b34d5,hpg_3ebbe4996edd55d5,2016-10-29,18,8,48,26
air_db1233ad855b34d5,hpg_3ebbe4996edd55d5,2016-11-01,2,2,7,4
air_db1233ad855b34d5,hpg_3ebbe4996edd55d5,2016-11-04,2,2,22,4
air_db1233ad855b34d5,hpg_3ebbe4996edd55d5,2016-11-05,17,13,40,30
air_db1233ad855b34d5,hpg_3ebbe4996edd55d5,2016-11-10,5,5,13,10
air_db1233ad855b34d5,hpg_3ebbe4996edd55d5,2016-11-15,3,3,11,6
air_db1233ad855b34d5,hpg_3ebbe4996edd55d5,2016-11-16,9,3,62,12
air_db1233ad855b34d5,hpg_3ebbe4996edd55d5,2016-11-18,15,44,36,59
air_db1233ad855b34d5,hpg_3ebbe4996edd55d5,2016-11-24,16,7,46,23
air_db1233ad855b34d5,hpg_3ebbe4996edd55d5,2016-11-26,18,2,52,20
air_db1233ad855b34d5,hpg_3ebbe4996edd55d5,2016-11-27,1,1,15,2
air_db1233ad855b34d5,hpg_3ebbe4996edd55d5,2016-12-02,18,11,42,29
air_db1233ad855b34d5,hpg_3ebbe4996edd55d5,2016-12-04,4,4,27,8
air_db1233ad855b34d5,hpg_3ebbe4996edd55d5,2016-12-09,24,14,41,38
air_db1233ad855b34d5,hpg_3ebbe4996edd55d5,2016-12-10,39,11,102,50
air_db1233ad855b34d5,hpg_3ebbe4996edd55d5,2016-12-15,10,16,34,26
air_db1233ad855b34d5,hpg_3ebbe4996edd55d5,2016-12-16,36,41,56,77
air_db1233ad855b34d5,hpg_3ebbe4996edd55d5,2016-12-17,36,30,69,66
air_db1233ad855b34d5,hpg_3ebbe4996edd55d5,2016-12-19,2,2,39,4
air_db1233ad855b34d5,hpg_3ebbe4996edd55d5,2016-12-21,12,5,26,17
air_db1233ad855b34d5,hpg_3ebbe4996edd55d5,2016-12-22,5,4,63,9
air_db1233ad855b34d5,hpg_3ebbe4996edd55d5,2016-12-28,32,25,63,57
air_db1233ad855b34d5,hpg_3ebbe4996edd55d5,2016-12-29,44,23,109,67
air_db1233ad855b34d5,hpg_3ebbe4996edd55d5,2016-12-30,44,22,73,66
air_db1233ad855b34d5,hpg_3ebbe4996edd55d5,2017-01-02,25,27,55,52
air_db1233ad855b34d5,hpg_3ebbe4996edd55d5,2017-01-08,11,9,21,20
air_db1233ad855b34d5,hpg_3ebbe4996edd55d5,2017-01-14,16,2,52,18
air_db1233ad855b34d5,hpg_3ebbe4996edd55d5,2017-01-18,12,8,19,20
air_db1233ad855b34d5,hpg_3ebbe4996edd55d5,2017-01-20,32,9,45,41
air_db1233ad855b34d5,hpg_3ebbe4996edd55d5,2017-01-21,29,2,54,31
air_db1233ad855b34d5,hpg_3ebbe4996edd55d5,2017-01-25,13,2,39,15
air_db1233ad855b34d5,hpg_3ebbe4996edd55d5,2017-01-27,28,2,41,30
air_db1233ad855b34d5,hpg_3ebbe4996edd55d5,2017-01-28,13,3,47,16
air_db1233ad855b34d5,hpg_3ebbe4996edd55d5,2017-01-29,7,2,28,9
air_db1233ad855b34d5,hpg_3ebbe4996edd55d5,2017-02-04,28,6,50,34
air_db1233ad855b34d5,hpg_3ebbe4996edd55d5,2017-02-05,7,3,43,10
air_db1233ad855b34d5,hpg_3ebbe4996edd55d5,2017-02-10,7,5,32,12
air_db1233ad855b34d5,hpg_3ebbe4996edd55d5,2017-02-11,6,2,44,8
air_db1233ad855b34d5,hpg_3ebbe4996edd55d5,2017-02-12,2,2,15,4
air_db1233ad855b34d5,hpg_3ebbe4996edd55d5,2017-02-17,11,11,24,22
air_db1233ad855b34d5,hpg_3ebbe4996edd55d5,2017-02-18,11,8,57,19
air_db1233ad855b34d5,hpg_3ebbe4996edd55d5,2017-02-23,3,3,16,6
air_db1233ad855b34d5,hpg_3ebbe4996edd55d5,2017-02-24,23,17,50,40
air_db1233ad855b34d5,hpg_3ebbe4996edd55d5,2017-02-25,28,23,70,51
air_db1233ad855b34d5,hpg_3ebbe4996edd55d5,2017-02-26,6,2,15,8
air_db1233ad855b34d5,hpg_3ebbe4996edd55d5,2017-03-01,25,5,33,30
air_db1233ad855b34d5,hpg_3ebbe4996edd55d5,2017-03-02,7,2,23,9
air_db1233ad855b34d5,hpg_3ebbe4996edd55d5,2017-03-03,2,2,6,4
air_db1233ad855b34d5,hpg_3ebbe4996edd55d5,2017-03-04,25,16,41,41
air_db1233ad855b34d5,hpg_3ebbe4996edd55d5,2017-03-05,7,7,29,14
air_db1233ad855b34d5,hpg_3ebbe4996edd55d5,2017-03-06,4,3,14,7
air_db1233ad855b34d5,hpg_3ebbe4996edd55d5,2017-03-08,21,4,54,25
air_db1233ad855b34d5,hpg_3ebbe4996edd55d5,2017-03-10,14,14,40,28
air_db1233ad855b34d5,hpg_3ebbe4996edd55d5,2017-03-11,53,11,63,64
air_db1233ad855b34d5,hpg_3ebbe4996edd55d5,2017-03-15,40,33,61,73
air_db1233ad855b34d5,hpg_3ebbe4996edd55d5,2017-03-17,37,7,47,44
air_db1233ad855b34d5,hpg_3ebbe4996edd55d5,2017-03-18,34,36,61,70
air_db1233ad855b34d5,hpg_3ebbe4996edd55d5,2017-03-19,28,16,47,44
air_db1233ad855b34d5,hpg_3ebbe4996edd55d5,2017-03-24,45,18,53,63
air_db1233ad855b34d5,hpg_3ebbe4996edd55d5,2017-03-25,32,14,85,46
air_db1233ad855b34d5,hpg_3ebbe4996edd55d5,2017-03-26,5,5,42,10
air_db1233ad855b34d5,hpg_3ebbe4996edd55d5,2017-03-28,17,2,44,19
air_db1233ad855b34d5,hpg_3ebbe4996edd55d5,2017-03-31,13,13,28,26
air_db1233ad855b34d5,hpg_3ebbe4996edd55d5,2017-04-05,18,3,25,21
air_db1233ad855b34d5,hpg_3ebbe4996edd55d5,2017-04-07,22,28,45,50
air_db1233ad855b34d5,hpg_3ebbe4996edd55d5,2017-04-08,19,4,44,23
air_db1233ad855b34d5,hpg_3ebbe4996edd55d5,2017-04-12,2,2,6,4
air_db1233ad855b34d5,hpg_3ebbe4996edd55d5,2017-04-14,36,29,47,65
air_db1233ad855b34d5,hpg_3ebbe4996edd55d5,2017-04-21,45,27,54,72
air_db1233ad855b34d5,hpg_3ebbe4996edd55d5,2017-04-22,18,18,46,36
air_6b15edd1b4fbb96a,hpg_babe2c3d962d7bb6,2016-01-02,11,9,96,20
air_6b15edd1b4fbb96a,hpg_babe2c3d962d7bb6,2016-01-09,8,4,47,12
air_6b15edd1b4fbb96a,hpg_babe2c3d962d7bb6,2016-01-11,2,2,25,4
air_6b15edd1b4fbb96a,hpg_babe2c3d962d7bb6,2016-01-12,4,2,27,6
air_6b15edd1b4fbb96a,hpg_babe2c3d962d7bb6,2016-01-15,10,5,49,15
air_6b15edd1b4fbb96a,hpg_babe2c3d962d7bb6,2016-01-20,7,7,20,14
air_6b15edd1b4fbb96a,hpg_babe2c3d962d7bb6,2016-01-22,23,5,52,28
air_6b15edd1b4fbb96a,hpg_babe2c3d962d7bb6,2016-01-23,11,2,39,13
air_6b15edd1b4fbb96a,hpg_babe2c3d962d7bb6,2016-01-24,9,2,37,11
air_6b15edd1b4fbb96a,hpg_babe2c3d962d7bb6,2016-01-29,19,10,34,29
air_6b15edd1b4fbb96a,hpg_babe2c3d962d7bb6,2016-01-30,32,20,78,52
air_6b15edd1b4fbb96a,hpg_babe2c3d962d7bb6,2016-01-31,7,2,49,9
air_6b15edd1b4fbb96a,hpg_babe2c3d962d7bb6,2016-02-02,4,2,32,6
air_6b15edd1b4fbb96a,hpg_babe2c3d962d7bb6,2016-02-05,18,2,43,20
air_6b15edd1b4fbb96a,hpg_babe2c3d962d7bb6,2016-02-06,21,7,75,28
air_6b15edd1b4fbb96a,hpg_babe2c3d962d7bb6,2016-02-09,15,6,27,21
air_6b15edd1b4fbb96a,hpg_babe2c3d962d7bb6,2016-02-11,8,6,52,14
air_6b15edd1b4fbb96a,hpg_babe2c3d962d7bb6,2016-02-12,25,4,41,29
air_6b15edd1b4fbb96a,hpg_babe2c3d962d7bb6,2016-02-13,16,7,59,23
air_6b15edd1b4fbb96a,hpg_babe2c3d962d7bb6,2016-02-15,14,8,28,22
air_6b15edd1b4fbb96a,hpg_babe2c3d962d7bb6,2016-02-19,10,8,40,18
air_6b15edd1b4fbb96a,hpg_babe2c3d962d7bb6,2016-02-20,29,25,53,54
air_6b15edd1b4fbb96a,hpg_babe2c3d962d7bb6,2016-02-21,23,4,55,27
air_6b15edd1b4fbb96a,hpg_babe2c3d962d7bb6,2016-02-22,6,4,14,10
air_6b15edd1b4fbb96a,hpg_babe2c3d962d7bb6,2016-02-23,4,2,23,6
air_6b15edd1b4fbb96a,hpg_babe2c3d962d7bb6,2016-02-24,4,4,21,8
air_6b15edd1b4fbb96a,hpg_babe2c3d962d7bb6,2016-02-25,7,5,36,12
air_6b15edd1b4fbb96a,hpg_babe2c3d962d7bb6,2016-02-26,10,2,47,12
air_6b15edd1b4fbb96a,hpg_babe2c3d962d7bb6,2016-02-27,40,13,91,53
air_6b15edd1b4fbb96a,hpg_babe2c3d962d7bb6,2016-02-28,2,2,40,4
air_6b15edd1b4fbb96a,hpg_babe2c3d962d7bb6,2016-02-29,2,2,12,4
air_6b15edd1b4fbb96a,hpg_babe2c3d962d7bb6,2016-03-06,24,14,46,38
air_6b15edd1b4fbb96a,hpg_babe2c3d962d7bb6,2016-03-10,14,12,31,26
air_6b15edd1b4fbb96a,hpg_babe2c3d962d7bb6,2016-03-11,18,10,42,28
air_6b15edd1b4fbb96a,hpg_babe2c3d962d7bb6,2016-03-12,35,14,68,49
air_6b15edd1b4fbb96a,hpg_babe2c3d962d7bb6,2016-03-15,4,3,27,7
air_6b15edd1b4fbb96a,hpg_babe2c3d962d7bb6,2016-03-16,9,5,32,14
air_6b15edd1b4fbb96a,hpg_babe2c3d962d7bb6,2016-03-17,7,2,36,9
air_6b15edd1b4fbb96a,hpg_babe2c3d962d7bb6,2016-03-19,9,13,72,22
air_6b15edd1b4fbb96a,hpg_babe2c3d962d7bb6,2016-03-22,4,4,9,8
air_6b15edd1b4fbb96a,hpg_babe2c3d962d7bb6,2016-03-24,8,4,26,12
air_6b15edd1b4fbb96a,hpg_babe2c3d962d7bb6,2016-03-26,25,11,79,36
air_6b15edd1b4fbb96a,hpg_babe2c3d962d7bb6,2016-03-27,9,6,48,15
air_6b15edd1b4fbb96a,hpg_babe2c3d962d7bb6,2016-03-28,9,2,36,11
air_6b15edd1b4fbb96a,hpg_babe2c3d962d7bb6,2016-03-30,2,6,29,8
air_6b15edd1b4fbb96a,hpg_babe2c3d962d7bb6,2016-04-01,7,2,43,9
air_6b15edd1b4fbb96a,hpg_babe2c3d962d7bb6,2016-04-02,39,7,81,46
air_6b15edd1b4fbb96a,hpg_babe2c3d962d7bb6,2016-04-04,7,4,20,11
air_6b15edd1b4fbb96a,hpg_babe2c3d962d7bb6,2016-04-07,2,2,14,4
air_6b15edd1b4fbb96a,hpg_babe2c3d962d7bb6,2016-04-09,29,12,82,41
air_6b15edd1b4fbb96a,hpg_babe2c3d962d7bb6,2016-04-10,8,2,48,10
air_6b15edd1b4fbb96a,hpg_babe2c3d962d7bb6,2016-04-11,2,2,22,4
air_6b15edd1b4fbb96a,hpg_babe2c3d962d7bb6,2016-04-13,4,2,19,6
air_6b15edd1b4fbb96a,hpg_babe2c3d962d7bb6,2016-04-15,3,4,43,7
air_6b15edd1b4fbb96a,hpg_babe2c3d962d7bb6,2016-04-16,19,9,77,28
air_6b15edd1b4fbb96a,hpg_babe2c3d962d7bb6,2016-04-17,38,5,65,43
air_6b15edd1b4fbb96a,hpg_babe2c3d962d7bb6,2016-04-20,10,4,32,14
air_6b15edd1b4fbb96a,hpg_babe2c3d962d7bb6,2016-04-22,15,2,51,17
air_6b15edd1b4fbb96a,hpg_babe2c3d962d7bb6,2016-04-23,26,16,85,42
air_6b15edd1b4fbb96a,hpg_babe2c3d962d7bb6,2016-04-24,4,2,41,6
air_6b15edd1b4fbb96a,hpg_babe2c3d962d7bb6,2016-04-27,18,6,25,24
air_6b15edd1b4fbb96a,hpg_babe2c3d962d7bb6,2016-04-28,24,2,28,26
air_6b15edd1b4fbb96a,hpg_babe2c3d962d7bb6,2016-04-29,30,13,78,43
air_6b15edd1b4fbb96a,hpg_babe2c3d962d7bb6,2016-04-30,31,8,72,39
air_6b15edd1b4fbb96a,hpg_babe2c3d962d7bb6,2016-05-02,14,2,53,16
air_6b15edd1b4fbb96a,hpg_babe2c3d962d7bb6,2016-05-03,33,12,81,45
air_6b15edd1b4fbb96a,hpg_babe2c3d962d7bb6,2016-05-04,24,14,73,38
air_6b15edd1b4fbb96a,hpg_babe2c3d962d7bb6,2016-05-06,10,10,40,20
air_6b15edd1b4fbb96a,hpg_babe2c3d962d7bb6,2016-05-07,28,6,53,34
air_6b15edd1b4fbb96a,hpg_babe2c3d962d7bb6,2016-05-12,6,6,10,12
air_6b15edd1b4fbb96a,hpg_babe2c3d962d7bb6,2016-05-14,28,3,96,31
air_6b15edd1b4fbb96a,hpg_babe2c3d962d7bb6,2016-05-15,19,2,52,21
air_6b15edd1b4fbb96a,hpg_babe2c3d962d7bb6,2016-05-16,6,2,23,8
air_6b15edd1b4fbb96a,hpg_babe2c3d962d7bb6,2016-05-18,4,4,41,8
air_6b15edd1b4fbb96a,hpg_babe2c3d962d7bb6,2016-05-21,14,12,76,26
air_6b15edd1b4fbb96a,hpg_babe2c3d962d7bb6,2016-05-22,13,2,61,15
air_6b15edd1b4fbb96a,hpg_babe2c3d962d7bb6,2016-05-24,14,2,41,16
air_6b15edd1b4fbb96a,hpg_babe2c3d962d7bb6,2016-10-28,4,2,28,6
air_6b15edd1b4fbb96a,hpg_babe2c3d962d7bb6,2016-10-29,6,11,42,17
air_6b15edd1b4fbb96a,hpg_babe2c3d962d7bb6,2016-10-30,7,12,43,19
air_6b15edd1b4fbb96a,hpg_babe2c3d962d7bb6,2016-10-31,5,2,14,7
air_6b15edd1b4fbb96a,hpg_babe2c3d962d7bb6,2016-11-03,7,5,38,12
air_6b15edd1b4fbb96a,hpg_babe2c3d962d7bb6,2016-11-04,16,7,34,23
air_6b15edd1b4fbb96a,hpg_babe2c3d962d7bb6,2016-11-05,23,11,72,34
air_6b15edd1b4fbb96a,hpg_babe2c3d962d7bb6,2016-11-06,5,4,36,9
air_6b15edd1b4fbb96a,hpg_babe2c3d962d7bb6,2016-11-07,5,2,25,7
air_6b15edd1b4fbb96a,hpg_babe2c3d962d7bb6,2016-11-11,18,6,44,24
air_6b15edd1b4fbb96a,hpg_babe2c3d962d7bb6,2016-11-12,22,2,53,24
air_6b15edd1b4fbb96a,hpg_babe2c3d962d7bb6,2016-11-16,7,3,17,10
air_6b15edd1b4fbb96a,hpg_babe2c3d962d7bb6,2016-11-18,21,23,44,44
air_6b15edd1b4fbb96a,hpg_babe2c3d962d7bb6,2016-11-19,37,6,67,43
air_6b15edd1b4fbb96a,hpg_babe2c3d962d7bb6,2016-11-20,12,13,53,25
air_6b15edd1b4fbb96a,hpg_babe2c3d962d7bb6,2016-11-21,11,5,27,16
air_6b15edd1b4fbb96a,hpg_babe2c3d962d7bb6,2016-11-23,7,2,56,9
air_6b15edd1b4fbb96a,hpg_babe2c3d962d7bb6,2016-11-24,7,2,22,9
air_6b15edd1b4fbb96a,hpg_babe2c3d962d7bb6,2016-11-25,24,5,45,29
air_6b15edd1b4fbb96a,hpg_babe2c3d962d7bb6,2016-11-26,14,15,91,29
air_6b15edd1b4fbb96a,hpg_babe2c3d962d7bb6,2016-11-28,7,7,17,14
air_6b15edd1b4fbb96a,hpg_babe2c3d962d7bb6,2016-11-29,11,2,32,13
air_6b15edd1b4fbb96a,hpg_babe2c3d962d7bb6,2016-12-03,41,29,81,70
air_6b15edd1b4fbb96a,hpg_babe2c3d962d7bb6,2016-12-06,2,5,10,7
air_6b15edd1b4fbb96a,hpg_babe2c3d962d7bb6,2016-12-08,24,8,31,32
air_6b15edd1b4fbb96a,hpg_babe2c3d962d7bb6,2016-12-10,24,24,36,48
air_6b15edd1b4fbb96a,hpg_babe2c3d962d7bb6,2016-12-11,14,7,63,21
air_6b15edd1b4fbb96a,hpg_babe2c3d962d7bb6,2016-12-13,5,2,11,7
air_6b15edd1b4fbb96a,hpg_babe2c3d962d7bb6,2016-12-14,6,8,27,14
air_6b15edd1b4fbb96a,hpg_babe2c3d962d7bb6,2016-12-16,24,18,34,42
air_6b15edd1b4fbb96a,hpg_babe2c3d962d7bb6,2016-12-17,46,56,103,102
air_6b15edd1b4fbb96a,hpg_babe2c3d962d7bb6,2016-12-18,22,10,47,32
air_6b15edd1b4fbb96a,hpg_babe2c3d962d7bb6,2016-12-20,7,4,22,11
air_6b15edd1b4fbb96a,hpg_babe2c3d962d7bb6,2016-12-22,8,8,38,16
air_6b15edd1b4fbb96a,hpg_babe2c3d962d7bb6,2016-12-23,18,12,30,30
air_6b15edd1b4fbb96a,hpg_babe2c3d962d7bb6,2016-12-24,55,46,70,101
air_6b15edd1b4fbb96a,hpg_babe2c3d962d7bb6,2016-12-25,32,8,52,40
air_6b15edd1b4fbb96a,hpg_babe2c3d962d7bb6,2016-12-26,6,4,14,10
air_6b15edd1b4fbb96a,hpg_babe2c3d962d7bb6,2016-12-27,23,12,33,35
air_6b15edd1b4fbb96a,hpg_babe2c3d962d7bb6,2016-12-28,26,24,69,50
air_6b15edd1b4fbb96a,hpg_babe2c3d962d7bb6,2016-12-29,39,38,78,77
air_6b15edd1b4fbb96a,hpg_babe2c3d962d7bb6,2016-12-30,35,27,76,62
air_6b15edd1b4fbb96a,hpg_babe2c3d962d7bb6,2017-01-02,29,2,71,31
air_6b15edd1b4fbb96a,hpg_babe2c3d962d7bb6,2017-01-03,27,7,67,34
air_6b15edd1b4fbb96a,hpg_babe2c3d962d7bb6,2017-01-06,5,5,13,10
air_6b15edd1b4fbb96a,hpg_babe2c3d962d7bb6,2017-01-07,22,29,46,51
air_6b15edd1b4fbb96a,hpg_babe2c3d962d7bb6,2017-01-08,21,13,39,34
air_6b15edd1b4fbb96a,hpg_babe2c3d962d7bb6,2017-01-09,7,3,39,10
air_6b15edd1b4fbb96a,hpg_babe2c3d962d7bb6,2017-01-11,4,2,18,6
air_6b15edd1b4fbb96a,hpg_babe2c3d962d7bb6,2017-01-13,28,28,40,56
air_6b15edd1b4fbb96a,hpg_babe2c3d962d7bb6,2017-01-15,15,2,30,17
air_6b15edd1b4fbb96a,hpg_babe2c3d962d7bb6,2017-01-21,27,22,62,49
air_6b15edd1b4fbb96a,hpg_babe2c3d962d7bb6,2017-01-22,11,4,37,15
air_6b15edd1b4fbb96a,hpg_babe2c3d962d7bb6,2017-01-28,14,6,78,20
air_6b15edd1b4fbb96a,hpg_babe2c3d962d7bb6,2017-01-29,15,2,67,17
air_6b15edd1b4fbb96a,hpg_babe2c3d962d7bb6,2017-02-01,2,2,10,4
air_6b15edd1b4fbb96a,hpg_babe2c3d962d7bb6,2017-02-03,13,3,31,16
air_6b15edd1b4fbb96a,hpg_babe2c3d962d7bb6,2017-02-04,13,7,55,20
air_6b15edd1b4fbb96a,hpg_babe2c3d962d7bb6,2017-02-05,15,2,38,17
air_6b15edd1b4fbb96a,hpg_babe2c3d962d7bb6,2017-02-06,2,4,16,6
air_6b15edd1b4fbb96a,hpg_babe2c3d962d7bb6,2017-02-07,8,2,28,10
air_6b15edd1b4fbb96a,hpg_babe2c3d962d7bb6,2017-02-11,16,10,57,26
air_6b15edd1b4fbb96a,hpg_babe2c3d962d7bb6,2017-02-13,7,5,26,12
air_6b15edd1b4fbb96a,hpg_babe2c3d962d7bb6,2017-02-15,8,2,30,10
air_6b15edd1b4fbb96a,hpg_babe2c3d962d7bb6,2017-02-17,28,11,32,39
air_6b15edd1b4fbb96a,hpg_babe2c3d962d7bb6,2017-02-18,25,15,45,40
air_6b15edd1b4fbb96a,hpg_babe2c3d962d7bb6,2017-02-19,12,2,57,14
air_6b15edd1b4fbb96a,hpg_babe2c3d962d7bb6,2017-02-24,9,6,37,15
air_6b15edd1b4fbb96a,hpg_babe2c3d962d7bb6,2017-02-25,21,7,64,28
air_6b15edd1b4fbb96a,hpg_babe2c3d962d7bb6,2017-02-26,12,2,35,14
air_6b15edd1b4fbb96a,hpg_babe2c3d962d7bb6,2017-02-28,8,8,21,16
air_6b15edd1b4fbb96a,hpg_babe2c3d962d7bb6,2017-03-02,4,2,29,6
air_6b15edd1b4fbb96a,hpg_babe2c3d962d7bb6,2017-03-03,15,7,25,22
air_6b15edd1b4fbb96a,hpg_babe2c3d962d7bb6,2017-03-04,7,12,39,19
air_6b15edd1b4fbb96a,hpg_babe2c3d962d7bb6,2017-03-05,25,13,42,38
air_6b15edd1b4fbb96a,hpg_babe2c3d962d7bb6,2017-03-08,10,3,21,13
air_6b15edd1b4fbb96a,hpg_babe2c3d962d7bb6,2017-03-11,23,10,63,33
air_6b15edd1b4fbb96a,hpg_babe2c3d962d7bb6,2017-03-13,7,2,20,9
air_6b15edd1b4fbb96a,hpg_babe2c3d962d7bb6,2017-03-14,14,9,32,23
air_6b15edd1b4fbb96a,hpg_babe2c3d962d7bb6,2017-03-16,9,2,28,11
air_6b15edd1b4fbb96a,hpg_babe2c3d962d7bb6,2017-03-17,24,2,35,26
air_6b15edd1b4fbb96a,hpg_babe2c3d962d7bb6,2017-03-18,25,7,76,32
air_6b15edd1b4fbb96a,hpg_babe2c3d962d7bb6,2017-03-19,23,10,58,33
air_6b15edd1b4fbb96a,hpg_babe2c3d962d7bb6,2017-03-20,15,2,54,17
air_6b15edd1b4fbb96a,hpg_babe2c3d962d7bb6,2017-03-22,7,4,30,11
air_6b15edd1b4fbb96a,hpg_babe2c3d962d7bb6,2017-03-23,19,3,39,22
air_6b15edd1b4fbb96a,hpg_babe2c3d962d7bb6,2017-03-24,18,5,51,23
air_6b15edd1b4fbb96a,hpg_babe2c3d962d7bb6,2017-03-25,27,7,71,34
air_6b15edd1b4fbb96a,hpg_babe2c3d962d7bb6,2017-03-26,11,9,46,20
air_6b15edd1b4fbb96a,hpg_babe2c3d962d7bb6,2017-03-28,4,2,22,6
air_6b15edd1b4fbb96a,hpg_babe2c3d962d7bb6,2017-03-29,18,5,39,23
air_6b15edd1b4fbb96a,hpg_babe2c3d962d7bb6,2017-03-31,12,6,30,18
air_6b15edd1b4fbb96a,hpg_babe2c3d962d7bb6,2017-04-02,6,2,34,8
air_6b15edd1b4fbb96a,hpg_babe2c3d962d7bb6,2017-04-03,9,2,25,11
air_6b15edd1b4fbb96a,hpg_babe2c3d962d7bb6,2017-04-04,6,2,13,8
air_6b15edd1b4fbb96a,hpg_babe2c3d962d7bb6,2017-04-05,17,12,29,29
air_6b15edd1b4fbb96a,hpg_babe2c3d962d7bb6,2017-04-08,23,7,61,30
air_6b15edd1b4fbb96a,hpg_babe2c3d962d7bb6,2017-04-09,4,4,37,8
air_6b15edd1b4fbb96a,hpg_babe2c3d962d7bb6,2017-04-14,31,2,40,33
air_6b15edd1b4fbb96a,hpg_babe2c3d962d7bb6,2017-04-15,20,14,48,34
air_6b15edd1b4fbb96a,hpg_babe2c3d962d7bb6,2017-04-17,6,2,18,8
air_6b15edd1b4fbb96a,hpg_babe2c3d962d7bb6,2017-04-21,13,16,40,29
air_6b15edd1b4fbb96a,hpg_babe2c3d962d7bb6,2017-04-22,23,11,80,34
air_fea5dc9594450608,hpg_6507818140022452,2016-10-28,15,15,23,30
air_fea5dc9594450608,hpg_6507818140022452,2016-11-12,4,2,28,6
air_fea5dc9594450608,hpg_6507818140022452,2016-11-18,2,2,14,4
air_fea5dc9594450608,hpg_6507818140022452,2016-11-19,4,2,24,6
air_fea5dc9594450608,hpg_6507818140022452,2016-11-30,15,6,9,21
air_fea5dc9594450608,hpg_6507818140022452,2016-12-02,8,8,14,16
air_fea5dc9594450608,hpg_6507818140022452,2016-12-07,13,4,18,17
air_fea5dc9594450608,hpg_6507818140022452,2016-12-10,4,4,17,8
air_fea5dc9594450608,hpg_6507818140022452,2016-12-17,13,10,44,23
air_fea5dc9594450608,hpg_6507818140022452,2016-12-20,11,9,29,20
air_fea5dc9594450608,hpg_6507818140022452,2016-12-24,4,6,25,10
air_fea5dc9594450608,hpg_6507818140022452,2016-12-28,7,5,37,12
air_fea5dc9594450608,hpg_6507818140022452,2017-01-14,4,4,17,8
air_fea5dc9594450608,hpg_6507818140022452,2017-01-16,2,2,4,4
air_fea5dc9594450608,hpg_6507818140022452,2017-01-18,2,2,21,4
air_fea5dc9594450608,hpg_6507818140022452,2017-01-20,8,4,22,12
air_fea5dc9594450608,hpg_6507818140022452,2017-01-21,6,4,19,10
air_fea5dc9594450608,hpg_6507818140022452,2017-02-02,4,4,42,8
air_fea5dc9594450608,hpg_6507818140022452,2017-02-03,9,9,27,18
air_fea5dc9594450608,hpg_6507818140022452,2017-02-08,12,12,20,24
air_fea5dc9594450608,hpg_6507818140022452,2017-02-10,5,5,8,10
air_fea5dc9594450608,hpg_6507818140022452,2017-02-11,6,4,24,10
air_fea5dc9594450608,hpg_6507818140022452,2017-02-18,5,6,35,11
air_fea5dc9594450608,hpg_6507818140022452,2017-02-20,10,6,10,16
air_fea5dc9594450608,hpg_6507818140022452,2017-03-08,2,2,15,4
air_fea5dc9594450608,hpg_6507818140022452,2017-03-16,3,3,7,6
air_fea5dc9594450608,hpg_6507818140022452,2017-03-18,10,10,23,20
air_fea5dc9594450608,hpg_6507818140022452,2017-03-23,8,8,22,16
air_fea5dc9594450608,hpg_6507818140022452,2017-03-25,6,5,13,11
air_fea5dc9594450608,hpg_6507818140022452,2017-03-29,2,2,14,4
air_fea5dc9594450608,hpg_6507818140022452,2017-03-30,5,3,3,8
air_fea5dc9594450608,hpg_6507818140022452,2017-04-08,5,5,31,10
air_fea5dc9594450608,hpg_6507818140022452,2017-04-15,4,4,20,8
air_fea5dc9594450608,hpg_6507818140022452,2017-04-18,2,2,16,4
air_fea5dc9594450608,hpg_6507818140022452,2017-04-21,10,2,28,12
air_fea5dc9594450608,hpg_6507818140022452,2017-04-22,2,2,14,4
air_e657ca554b0c008c,hpg_5c05683a8f326588,2017-03-11,2,2,49,4
air_0b1e72d2d4422b20,hpg_9fe427339d77b421,2016-10-27,3,3,10,6
air_0b1e72d2d4422b20,hpg_9fe427339d77b421,2016-10-28,11,8,21,19
air_0b1e72d2d4422b20,hpg_9fe427339d77b421,2016-11-03,3,3,61,6
air_0b1e72d2d4422b20,hpg_9fe427339d77b421,2016-11-05,6,2,43,8
air_0b1e72d2d4422b20,hpg_9fe427339d77b421,2016-11-11,2,2,8,4
air_0b1e72d2d4422b20,hpg_9fe427339d77b421,2016-11-18,9,6,18,15
air_0b1e72d2d4422b20,hpg_9fe427339d77b421,2016-12-03,24,12,21,36
air_0b1e72d2d4422b20,hpg_9fe427339d77b421,2016-12-07,9,7,33,16
air_0b1e72d2d4422b20,hpg_9fe427339d77b421,2016-12-09,4,9,10,13
air_0b1e72d2d4422b20,hpg_9fe427339d77b421,2016-12-10,16,5,40,21
air_0b1e72d2d4422b20,hpg_9fe427339d77b421,2016-12-13,2,2,21,4
air_0b1e72d2d4422b20,hpg_9fe427339d77b421,2016-12-17,19,13,54,32
air_0b1e72d2d4422b20,hpg_9fe427339d77b421,2016-12-22,11,6,14,17
air_0b1e72d2d4422b20,hpg_9fe427339d77b421,2016-12-27,2,2,11,4
air_0b1e72d2d4422b20,hpg_9fe427339d77b421,2016-12-28,5,3,23,8
air_0b1e72d2d4422b20,hpg_9fe427339d77b421,2016-12-30,17,8,51,25
air_0b1e72d2d4422b20,hpg_9fe427339d77b421,2017-01-02,2,8,27,10
air_0b1e72d2d4422b20,hpg_9fe427339d77b421,2017-01-06,11,3,14,14
air_0b1e72d2d4422b20,hpg_9fe427339d77b421,2017-01-13,5,7,22,12
air_0b1e72d2d4422b20,hpg_9fe427339d77b421,2017-01-21,3,2,27,5
air_0b1e72d2d4422b20,hpg_9fe427339d77b421,2017-01-27,4,5,17,9
air_0b1e72d2d4422b20,hpg_9fe427339d77b421,2017-01-28,7,4,35,11
air_0b1e72d2d4422b20,hpg_9fe427339d77b421,2017-02-03,4,1,12,5
air_0b1e72d2d4422b20,hpg_9fe427339d77b421,2017-02-04,4,3,32,7
air_0b1e72d2d4422b20,hpg_9fe427339d77b421,2017-02-11,5,4,46,9
air_0b1e72d2d4422b20,hpg_9fe427339d77b421,2017-02-15,2,3,22,5
air_0b1e72d2d4422b20,hpg_9fe427339d77b421,2017-02-23,2,2,10,4
air_0b1e72d2d4422b20,hpg_9fe427339d77b421,2017-02-24,7,5,15,12
air_0b1e72d2d4422b20,hpg_9fe427339d77b421,2017-02-25,5,8,19,13
air_0b1e72d2d4422b20,hpg_9fe427339d77b421,2017-02-28,5,2,29,7
air_0b1e72d2d4422b20,hpg_9fe427339d77b421,2017-03-04,6,8,31,14
air_0b1e72d2d4422b20,hpg_9fe427339d77b421,2017-03-07,7,2,13,9
air_0b1e72d2d4422b20,hpg_9fe427339d77b421,2017-03-17,10,8,25,18
air_0b1e72d2d4422b20,hpg_9fe427339d77b421,2017-03-19,2,5,41,7
air_0b1e72d2d4422b20,hpg_9fe427339d77b421,2017-03-24,14,2,21,16
air_0b1e72d2d4422b20,hpg_9fe427339d77b421,2017-03-25,2,4,31,6
air_0b1e72d2d4422b20,hpg_9fe427339d77b421,2017-03-29,4,2,23,6
air_0b1e72d2d4422b20,hpg_9fe427339d77b421,2017-04-01,6,6,38,12
air_0b1e72d2d4422b20,hpg_9fe427339d77b421,2017-04-07,13,4,13,17
air_0b1e72d2d4422b20,hpg_9fe427339d77b421,2017-04-08,12,6,34,18
air_0b1e72d2d4422b20,hpg_9fe427339d77b421,2017-04-14,4,2,16,6
air_0b1e72d2d4422b20,hpg_9fe427339d77b421,2017-04-15,2,4,38,6
air_0b1e72d2d4422b20,hpg_9fe427339d77b421,2017-04-20,3,3,24,6
air_0b1e72d2d4422b20,hpg_9fe427339d77b421,2017-04-22,6,4,26,10
air_789466e488705c93,hpg_4ca41b70c41bc844,2016-01-10,8,4,34,12
air_789466e488705c93,hpg_4ca41b70c41bc844,2016-01-16,44,10,50,54
air_789466e488705c93,hpg_4ca41b70c41bc844,2016-01-23,23,15,29,38
air_789466e488705c93,hpg_4ca41b70c41bc844,2016-01-29,39,6,48,45
air_789466e488705c93,hpg_4ca41b70c41bc844,2016-01-30,33,11,48,44
air_789466e488705c93,hpg_4ca41b70c41bc844,2016-02-02,3,3,19,6
air_789466e488705c93,hpg_4ca41b70c41bc844,2016-02-10,11,9,14,20
air_789466e488705c93,hpg_4ca41b70c41bc844,2016-02-12,7,21,21,28
air_789466e488705c93,hpg_4ca41b70c41bc844,2016-02-13,30,2,54,32
air_789466e488705c93,hpg_4ca41b70c41bc844,2016-02-17,8,8,15,16
air_789466e488705c93,hpg_4ca41b70c41bc844,2016-03-17,4,4,12,8
air_789466e488705c93,hpg_4ca41b70c41bc844,2016-03-20,34,4,47,38
air_789466e488705c93,hpg_4ca41b70c41bc844,2016-03-25,48,5,48,53
air_789466e488705c93,hpg_4ca41b70c41bc844,2016-03-26,5,18,44,23
air_789466e488705c93,hpg_4ca41b70c41bc844,2016-03-30,27,30,45,57
air_789466e488705c93,hpg_4ca41b70c41bc844,2016-04-02,2,2,10,4
air_789466e488705c93,hpg_4ca41b70c41bc844,2016-04-06,22,10,25,32
air_789466e488705c93,hpg_4ca41b70c41bc844,2016-04-09,27,6,35,33
air_789466e488705c93,hpg_4ca41b70c41bc844,2016-04-22,15,13,15,28
air_789466e488705c93,hpg_4ca41b70c41bc844,2016-04-23,39,4,45,43
air_789466e488705c93,hpg_4ca41b70c41bc844,2016-04-29,2,2,12,4
air_789466e488705c93,hpg_4ca41b70c41bc844,2016-05-02,13,3,24,16
air_789466e488705c93,hpg_4ca41b70c41bc844,2016-05-07,27,9,33,36
air_789466e488705c93,hpg_4ca41b70c41bc844,2016-10-28,9,4,20,13
air_789466e488705c93,hpg_4ca41b70c41bc844,2016-11-12,13,4,25,17
air_789466e488705c93,hpg_4ca41b70c41bc844,2016-11-16,5,2,13,7
air_789466e488705c93,hpg_4ca41b70c41bc844,2016-11-23,4,4,10,8
air_789466e488705c93,hpg_4ca41b70c41bc844,2016-11-29,5,5,14,10
air_789466e488705c93,hpg_4ca41b70c41bc844,2016-12-10,51,13,67,64
air_789466e488705c93,hpg_4ca41b70c41bc844,2016-12-14,3,3,12,6
air_789466e488705c93,hpg_4ca41b70c41bc844,2016-12-16,49,3,63,52
air_789466e488705c93,hpg_4ca41b70c41bc844,2016-12-17,40,34,46,74
air_789466e488705c93,hpg_4ca41b70c41bc844,2016-12-22,59,20,68,79
air_789466e488705c93,hpg_4ca41b70c41bc844,2016-12-23,9,7,16,16
air_789466e488705c93,hpg_4ca41b70c41bc844,2016-12-26,12,4,33,16
air_789466e488705c93,hpg_4ca41b70c41bc844,2016-12-27,24,24,52,48
air_789466e488705c93,hpg_4ca41b70c41bc844,2016-12-28,59,4,54,63
air_789466e488705c93,hpg_4ca41b70c41bc844,2016-12-29,50,4,52,54
air_789466e488705c93,hpg_4ca41b70c41bc844,2016-12-30,50,18,73,68
air_789466e488705c93,hpg_4ca41b70c41bc844,2017-01-04,2,2,29,4
air_789466e488705c93,hpg_4ca41b70c41bc844,2017-01-06,2,2,9,4
air_789466e488705c93,hpg_4ca41b70c41bc844,2017-01-07,47,12,55,59
air_789466e488705c93,hpg_4ca41b70c41bc844,2017-01-08,5,5,37,10
air_789466e488705c93,hpg_4ca41b70c41bc844,2017-01-11,11,11,1,22
air_789466e488705c93,hpg_4ca41b70c41bc844,2017-01-15,6,6,14,12
air_789466e488705c93,hpg_4ca41b70c41bc844,2017-01-17,2,2,11,4
air_789466e488705c93,hpg_4ca41b70c41bc844,2017-01-19,3,3,10,6
air_789466e488705c93,hpg_4ca41b70c41bc844,2017-01-20,2,2,12,4
air_789466e488705c93,hpg_4ca41b70c41bc844,2017-01-21,40,17,58,57
air_789466e488705c93,hpg_4ca41b70c41bc844,2017-01-27,30,2,37,32
air_789466e488705c93,hpg_4ca41b70c41bc844,2017-02-18,37,11,54,48
air_789466e488705c93,hpg_4ca41b70c41bc844,2017-02-25,35,10,39,45
air_789466e488705c93,hpg_4ca41b70c41bc844,2017-03-04,2,2,40,4
air_789466e488705c93,hpg_4ca41b70c41bc844,2017-03-09,3,3,9,6
air_789466e488705c93,hpg_4ca41b70c41bc844,2017-03-25,11,7,40,18
air_789466e488705c93,hpg_4ca41b70c41bc844,2017-03-26,9,13,13,22
air_789466e488705c93,hpg_4ca41b70c41bc844,2017-04-01,24,2,32,26
air_789466e488705c93,hpg_4ca41b70c41bc844,2017-04-08,22,2,45,24
air_789466e488705c93,hpg_4ca41b70c41bc844,2017-04-11,17,17,31,34
air_789466e488705c93,hpg_4ca41b70c41bc844,2017-04-14,42,11,43,53
air_789466e488705c93,hpg_4ca41b70c41bc844,2017-04-15,23,7,33,30
air_789466e488705c93,hpg_4ca41b70c41bc844,2017-04-19,9,9,16,18
air_789466e488705c93,hpg_4ca41b70c41bc844,2017-04-21,52,5,59,57
air_f0fb0975bdc2cdf9,hpg_0cd7a0f13e73b043,2017-04-15,2,6,10,8
air_0a74a5408a0b8642,hpg_2ded824e690c414a,2016-07-02,29,5,34,34
air_0a74a5408a0b8642,hpg_2ded824e690c414a,2016-07-07,30,2,34,32
air_0a74a5408a0b8642,hpg_2ded824e690c414a,2016-07-08,17,12,11,29
air_0a74a5408a0b8642,hpg_2ded824e690c414a,2016-07-09,39,4,48,43
air_0a74a5408a0b8642,hpg_2ded824e690c414a,2016-07-11,31,2,31,33
air_0a74a5408a0b8642,hpg_2ded824e690c414a,2016-07-13,32,2,36,34
air_0a74a5408a0b8642,hpg_2ded824e690c414a,2016-07-14,18,3,14,21
air_0a74a5408a0b8642,hpg_2ded824e690c414a,2016-07-16,39,2,41,41
air_0a74a5408a0b8642,hpg_2ded824e690c414a,2016-07-19,13,2,17,15
air_0a74a5408a0b8642,hpg_2ded824e690c414a,2016-10-28,39,4,39,43
air_0a74a5408a0b8642,hpg_2ded824e690c414a,2016-10-29,42,4,46,46
air_0a74a5408a0b8642,hpg_2ded824e690c414a,2016-10-31,15,4,17,19
air_0a74a5408a0b8642,hpg_2ded824e690c414a,2016-11-01,20,4,24,24
air_0a74a5408a0b8642,hpg_2ded824e690c414a,2016-11-02,23,4,28,27
air_0a74a5408a0b8642,hpg_2ded824e690c414a,2016-11-04,26,6,30,32
air_0a74a5408a0b8642,hpg_2ded824e690c414a,2016-11-05,46,6,51,52
air_0a74a5408a0b8642,hpg_2ded824e690c414a,2016-11-07,7,3,7,10
air_0a74a5408a0b8642,hpg_2ded824e690c414a,2016-11-12,29,5,33,34
air_0a74a5408a0b8642,hpg_2ded824e690c414a,2016-11-14,15,3,15,18
air_0a74a5408a0b8642,hpg_2ded824e690c414a,2016-11-17,31,4,31,35
air_0a74a5408a0b8642,hpg_2ded824e690c414a,2016-11-19,29,2,29,31
air_0a74a5408a0b8642,hpg_2ded824e690c414a,2016-11-22,47,2,48,49
air_0a74a5408a0b8642,hpg_2ded824e690c414a,2016-11-23,24,2,26,26
air_0a74a5408a0b8642,hpg_2ded824e690c414a,2016-11-25,38,4,38,42
air_0a74a5408a0b8642,hpg_2ded824e690c414a,2016-11-26,41,2,41,43
air_0a74a5408a0b8642,hpg_2ded824e690c414a,2016-11-28,28,2,24,30
air_0a74a5408a0b8642,hpg_2ded824e690c414a,2016-11-29,31,2,39,33
air_0a74a5408a0b8642,hpg_2ded824e690c414a,2016-12-02,30,4,32,34
air_0a74a5408a0b8642,hpg_2ded824e690c414a,2016-12-03,35,8,37,43
air_0a74a5408a0b8642,hpg_2ded824e690c414a,2016-12-05,32,4,32,36
air_0a74a5408a0b8642,hpg_2ded824e690c414a,2016-12-06,29,6,29,35
air_0a74a5408a0b8642,hpg_2ded824e690c414a,2016-12-09,40,14,39,54
air_0a74a5408a0b8642,hpg_2ded824e690c414a,2016-12-10,37,2,37,39
air_0a74a5408a0b8642,hpg_2ded824e690c414a,2016-12-12,30,2,32,32
air_0a74a5408a0b8642,hpg_2ded824e690c414a,2016-12-13,47,2,49,49
air_0a74a5408a0b8642,hpg_2ded824e690c414a,2016-12-14,38,2,38,40
air_0a74a5408a0b8642,hpg_2ded824e690c414a,2016-12-16,44,23,44,67
air_0a74a5408a0b8642,hpg_2ded824e690c414a,2016-12-17,67,2,65,69
air_0a74a5408a0b8642,hpg_2ded824e690c414a,2016-12-21,34,2,42,36
air_0a74a5408a0b8642,hpg_2ded824e690c414a,2016-12-22,34,15,44,49
air_0a74a5408a0b8642,hpg_2ded824e690c414a,2016-12-23,46,15,55,61
air_0a74a5408a0b8642,hpg_2ded824e690c414a,2016-12-24,69,44,67,113
air_0a74a5408a0b8642,hpg_2ded824e690c414a,2016-12-25,54,6,49,60
air_0a74a5408a0b8642,hpg_2ded824e690c414a,2016-12-26,38,2,49,40
air_0a74a5408a0b8642,hpg_2ded824e690c414a,2016-12-27,50,6,50,56
air_0a74a5408a0b8642,hpg_2ded824e690c414a,2016-12-28,41,14,43,55
air_0a74a5408a0b8642,hpg_2ded824e690c414a,2016-12-29,70,11,63,81
air_0a74a5408a0b8642,hpg_2ded824e690c414a,2016-12-30,52,9,54,61
air_0a74a5408a0b8642,hpg_2ded824e690c414a,2017-01-07,48,2,48,50
air_0a74a5408a0b8642,hpg_2ded824e690c414a,2017-01-14,42,6,36,48
air_0a74a5408a0b8642,hpg_2ded824e690c414a,2017-01-16,23,2,35,25
air_0a74a5408a0b8642,hpg_2ded824e690c414a,2017-01-19,39,2,33,41
air_0a74a5408a0b8642,hpg_2ded824e690c414a,2017-01-21,52,4,42,56
air_0a74a5408a0b8642,hpg_2ded824e690c414a,2017-01-24,30,5,22,35
air_0a74a5408a0b8642,hpg_2ded824e690c414a,2017-01-28,24,5,30,29
air_0a74a5408a0b8642,hpg_2ded824e690c414a,2017-02-02,47,20,37,67
air_0a74a5408a0b8642,hpg_2ded824e690c414a,2017-02-03,32,2,26,34
air_0a74a5408a0b8642,hpg_2ded824e690c414a,2017-02-04,44,8,53,52
air_0a74a5408a0b8642,hpg_2ded824e690c414a,2017-02-05,32,3,26,35
air_0a74a5408a0b8642,hpg_2ded824e690c414a,2017-02-10,48,3,34,51
air_0a74a5408a0b8642,hpg_2ded824e690c414a,2017-02-11,63,8,60,71
air_0a74a5408a0b8642,hpg_2ded824e690c414a,2017-02-12,10,4,16,14
air_0a74a5408a0b8642,hpg_2ded824e690c414a,2017-02-13,18,6,24,24
air_0a74a5408a0b8642,hpg_2ded824e690c414a,2017-02-16,38,4,33,42
air_0a74a5408a0b8642,hpg_2ded824e690c414a,2017-02-17,40,6,46,46
air_0a74a5408a0b8642,hpg_2ded824e690c414a,2017-02-18,64,7,59,71
air_0a74a5408a0b8642,hpg_2ded824e690c414a,2017-02-20,27,6,27,33
air_0a74a5408a0b8642,hpg_2ded824e690c414a,2017-02-25,46,2,44,48
air_0a74a5408a0b8642,hpg_2ded824e690c414a,2017-02-26,12,5,12,17
air_0a74a5408a0b8642,hpg_2ded824e690c414a,2017-03-03,45,2,33,47
air_0a74a5408a0b8642,hpg_2ded824e690c414a,2017-03-04,56,9,45,65
air_0a74a5408a0b8642,hpg_2ded824e690c414a,2017-03-05,21,3,21,24
air_0a74a5408a0b8642,hpg_2ded824e690c414a,2017-03-10,48,2,33,50
air_0a74a5408a0b8642,hpg_2ded824e690c414a,2017-03-11,45,16,35,61
air_0a74a5408a0b8642,hpg_2ded824e690c414a,2017-03-12,21,8,21,29
air_0a74a5408a0b8642,hpg_2ded824e690c414a,2017-03-14,45,2,47,47
air_0a74a5408a0b8642,hpg_2ded824e690c414a,2017-03-16,46,2,46,48
air_0a74a5408a0b8642,hpg_2ded824e690c414a,2017-03-17,40,4,43,44
air_0a74a5408a0b8642,hpg_2ded824e690c414a,2017-03-18,47,7,51,54
air_0a74a5408a0b8642,hpg_2ded824e690c414a,2017-03-19,40,2,40,42
air_0a74a5408a0b8642,hpg_2ded824e690c414a,2017-03-24,48,1,39,49
air_0a74a5408a0b8642,hpg_2ded824e690c414a,2017-03-26,41,2,43,43
air_0a74a5408a0b8642,hpg_2ded824e690c414a,2017-03-27,31,2,48,33
air_0a74a5408a0b8642,hpg_2ded824e690c414a,2017-03-28,28,10,30,38
air_0a74a5408a0b8642,hpg_2ded824e690c414a,2017-04-03,25,2,29,27
air_0a74a5408a0b8642,hpg_2ded824e690c414a,2017-04-08,33,2,27,35
air_0a74a5408a0b8642,hpg_2ded824e690c414a,2017-04-13,21,3,25,24
air_0a74a5408a0b8642,hpg_2ded824e690c414a,2017-04-14,42,2,47,44
air_0a74a5408a0b8642,hpg_2ded824e690c414a,2017-04-16,16,11,20,27
air_258ad2619d7bff9a,hpg_e87d00be48cd91c6,2016-12-28,20,8,65,28
air_258ad2619d7bff9a,hpg_e87d00be48cd91c6,2017-01-12,27,27,39,54
air_258ad2619d7bff9a,hpg_e87d00be48cd91c6,2017-02-15,5,14,26,19
air_258ad2619d7bff9a,hpg_e87d00be48cd91c6,2017-02-23,32,14,34,46
air_258ad2619d7bff9a,hpg_e87d00be48cd91c6,2017-03-24,36,13,73,49
air_258ad2619d7bff9a,hpg_e87d00be48cd91c6,2017-04-08,13,6,55,19
air_258ad2619d7bff9a,hpg_e87d00be48cd91c6,2017-04-12,45,5,54,50
air_9241121af22ff1d6,hpg_49dbe1fd79450e55,2016-02-12,3,3,24,6
air_9241121af22ff1d6,hpg_49dbe1fd79450e55,2016-03-25,16,15,38,31
air_9241121af22ff1d6,hpg_49dbe1fd79450e55,2016-03-26,5,25,50,30
air_9241121af22ff1d6,hpg_49dbe1fd79450e55,2016-04-09,17,7,48,24
air_9241121af22ff1d6,hpg_49dbe1fd79450e55,2016-04-23,10,10,37,20
air_9241121af22ff1d6,hpg_49dbe1fd79450e55,2016-05-21,2,2,33,4
air_9241121af22ff1d6,hpg_49dbe1fd79450e55,2016-10-28,19,4,43,23
air_9241121af22ff1d6,hpg_49dbe1fd79450e55,2016-10-29,10,5,60,15
air_9241121af22ff1d6,hpg_49dbe1fd79450e55,2016-11-11,2,2,41,4
air_9241121af22ff1d6,hpg_49dbe1fd79450e55,2016-11-14,3,3,23,6
air_9241121af22ff1d6,hpg_49dbe1fd79450e55,2016-12-03,8,2,56,10
air_9241121af22ff1d6,hpg_49dbe1fd79450e55,2016-12-10,6,3,51,9
air_9241121af22ff1d6,hpg_49dbe1fd79450e55,2016-12-17,8,3,57,11
air_9241121af22ff1d6,hpg_49dbe1fd79450e55,2016-12-30,11,5,41,16
air_9241121af22ff1d6,hpg_49dbe1fd79450e55,2017-01-14,7,2,52,9
air_9241121af22ff1d6,hpg_49dbe1fd79450e55,2017-01-28,2,2,42,4
air_9241121af22ff1d6,hpg_49dbe1fd79450e55,2017-02-21,2,2,20,4
air_9241121af22ff1d6,hpg_49dbe1fd79450e55,2017-03-14,15,4,28,19
air_9241121af22ff1d6,hpg_49dbe1fd79450e55,2017-03-18,7,5,62,12
air_9241121af22ff1d6,hpg_49dbe1fd79450e55,2017-04-09,3,3,47,6
air_9241121af22ff1d6,hpg_49dbe1fd79450e55,2017-04-15,2,2,47,4
air_5acc13d655a6e8b2,hpg_1f9643b5673938d9,2016-10-29,12,2,18,14
air_5acc13d655a6e8b2,hpg_1f9643b5673938d9,2016-11-18,17,11,30,28
air_5acc13d655a6e8b2,hpg_1f9643b5673938d9,2016-11-19,15,12,39,27
air_5acc13d655a6e8b2,hpg_1f9643b5673938d9,2016-11-26,10,2,31,12
air_5acc13d655a6e8b2,hpg_1f9643b5673938d9,2016-11-27,2,2,39,4
air_5acc13d655a6e8b2,hpg_1f9643b5673938d9,2016-11-29,9,12,19,21
air_5acc13d655a6e8b2,hpg_1f9643b5673938d9,2016-12-02,24,8,20,32
air_5acc13d655a6e8b2,hpg_1f9643b5673938d9,2016-12-03,22,5,56,27
air_5acc13d655a6e8b2,hpg_1f9643b5673938d9,2016-12-04,21,9,56,30
air_5acc13d655a6e8b2,hpg_1f9643b5673938d9,2016-12-06,15,15,22,30
air_5acc13d655a6e8b2,hpg_1f9643b5673938d9,2016-12-08,13,13,32,26
air_5acc13d655a6e8b2,hpg_1f9643b5673938d9,2016-12-09,21,8,34,29
air_5acc13d655a6e8b2,hpg_1f9643b5673938d9,2016-12-16,18,7,36,25
air_5acc13d655a6e8b2,hpg_1f9643b5673938d9,2016-12-22,14,10,43,24
air_5acc13d655a6e8b2,hpg_1f9643b5673938d9,2016-12-28,22,9,41,31
air_5acc13d655a6e8b2,hpg_1f9643b5673938d9,2016-12-29,7,5,51,12
air_5acc13d655a6e8b2,hpg_1f9643b5673938d9,2017-01-04,4,4,22,8
air_5acc13d655a6e8b2,hpg_1f9643b5673938d9,2017-01-28,9,7,23,16
air_5acc13d655a6e8b2,hpg_1f9643b5673938d9,2017-01-29,6,2,23,8
air_5acc13d655a6e8b2,hpg_1f9643b5673938d9,2017-02-03,28,4,39,32
air_5acc13d655a6e8b2,hpg_1f9643b5673938d9,2017-02-10,21,14,47,35
air_5acc13d655a6e8b2,hpg_1f9643b5673938d9,2017-02-15,13,2,26,15
air_5acc13d655a6e8b2,hpg_1f9643b5673938d9,2017-02-17,12,5,21,17
air_5acc13d655a6e8b2,hpg_1f9643b5673938d9,2017-02-18,6,7,36,13
air_5acc13d655a6e8b2,hpg_1f9643b5673938d9,2017-02-21,2,2,12,4
air_5acc13d655a6e8b2,hpg_1f9643b5673938d9,2017-03-11,2,5,40,7
air_5acc13d655a6e8b2,hpg_1f9643b5673938d9,2017-03-16,8,4,16,12
air_5acc13d655a6e8b2,hpg_1f9643b5673938d9,2017-03-24,8,10,27,18
air_5acc13d655a6e8b2,hpg_1f9643b5673938d9,2017-03-25,9,2,42,11
air_5acc13d655a6e8b2,hpg_1f9643b5673938d9,2017-03-26,10,4,31,14
air_5acc13d655a6e8b2,hpg_1f9643b5673938d9,2017-03-29,10,10,10,20
air_5acc13d655a6e8b2,hpg_1f9643b5673938d9,2017-04-01,6,6,46,12
air_5acc13d655a6e8b2,hpg_1f9643b5673938d9,2017-04-05,8,2,18,10
air_5acc13d655a6e8b2,hpg_1f9643b5673938d9,2017-04-06,17,14,24,31
air_5acc13d655a6e8b2,hpg_1f9643b5673938d9,2017-04-08,3,8,45,11
air_5acc13d655a6e8b2,hpg_1f9643b5673938d9,2017-04-14,33,15,48,48
air_5acc13d655a6e8b2,hpg_1f9643b5673938d9,2017-04-15,2,5,30,7
air_5acc13d655a6e8b2,hpg_1f9643b5673938d9,2017-04-16,2,4,15,6
air_5acc13d655a6e8b2,hpg_1f9643b5673938d9,2017-04-22,2,2,36,4
air_c6a164dd4060e960,hpg_8ce73856596a7794,2016-10-27,2,2,17,4
air_c6a164dd4060e960,hpg_8ce73856596a7794,2016-10-28,7,7,27,14
air_c6a164dd4060e960,hpg_8ce73856596a7794,2016-10-29,2,2,38,4
air_c6a164dd4060e960,hpg_8ce73856596a7794,2016-11-04,2,2,9,4
air_c6a164dd4060e960,hpg_8ce73856596a7794,2016-11-08,3,3,11,6
air_c6a164dd4060e960,hpg_8ce73856596a7794,2016-11-09,2,2,11,4
air_c6a164dd4060e960,hpg_8ce73856596a7794,2016-11-12,2,2,38,4
air_c6a164dd4060e960,hpg_8ce73856596a7794,2016-11-15,2,2,10,4
air_c6a164dd4060e960,hpg_8ce73856596a7794,2016-11-17,4,4,9,8
air_c6a164dd4060e960,hpg_8ce73856596a7794,2016-11-22,2,2,23,4
air_c6a164dd4060e960,hpg_8ce73856596a7794,2016-11-24,3,3,13,6
air_c6a164dd4060e960,hpg_8ce73856596a7794,2016-11-25,5,5,26,10
air_c6a164dd4060e960,hpg_8ce73856596a7794,2016-11-26,2,4,28,6
air_c6a164dd4060e960,hpg_8ce73856596a7794,2016-11-29,3,3,19,6
air_c6a164dd4060e960,hpg_8ce73856596a7794,2016-11-30,4,8,12,12
air_c6a164dd4060e960,hpg_8ce73856596a7794,2016-12-02,3,5,24,8
air_c6a164dd4060e960,hpg_8ce73856596a7794,2016-12-03,7,7,29,14
air_c6a164dd4060e960,hpg_8ce73856596a7794,2016-12-07,2,2,2,4
air_c6a164dd4060e960,hpg_8ce73856596a7794,2016-12-08,2,2,11,4
air_c6a164dd4060e960,hpg_8ce73856596a7794,2016-12-09,9,3,39,12
air_c6a164dd4060e960,hpg_8ce73856596a7794,2016-12-10,9,13,34,22
air_c6a164dd4060e960,hpg_8ce73856596a7794,2016-12-12,4,4,22,8
air_c6a164dd4060e960,hpg_8ce73856596a7794,2016-12-13,9,6,19,15
air_c6a164dd4060e960,hpg_8ce73856596a7794,2016-12-15,3,3,15,6
air_c6a164dd4060e960,hpg_8ce73856596a7794,2016-12-16,20,14,42,34
air_c6a164dd4060e960,hpg_8ce73856596a7794,2016-12-17,12,11,56,23
air_c6a164dd4060e960,hpg_8ce73856596a7794,2016-12-19,6,8,18,14
air_c6a164dd4060e960,hpg_8ce73856596a7794,2016-12-20,7,2,22,9
air_c6a164dd4060e960,hpg_8ce73856596a7794,2016-12-21,8,4,14,12
air_c6a164dd4060e960,hpg_8ce73856596a7794,2016-12-22,24,19,39,43
air_c6a164dd4060e960,hpg_8ce73856596a7794,2016-12-23,21,16,41,37
air_c6a164dd4060e960,hpg_8ce73856596a7794,2016-12-24,45,47,59,92
air_c6a164dd4060e960,hpg_8ce73856596a7794,2016-12-25,20,10,48,30
air_c6a164dd4060e960,hpg_8ce73856596a7794,2016-12-26,6,6,20,12
air_c6a164dd4060e960,hpg_8ce73856596a7794,2016-12-27,14,14,30,28
air_c6a164dd4060e960,hpg_8ce73856596a7794,2016-12-28,15,10,32,25
air_c6a164dd4060e960,hpg_8ce73856596a7794,2016-12-29,30,8,56,38
air_c6a164dd4060e960,hpg_8ce73856596a7794,2017-01-07,2,2,6,4
air_c6a164dd4060e960,hpg_8ce73856596a7794,2017-01-10,2,2,4,4
air_c6a164dd4060e960,hpg_8ce73856596a7794,2017-01-13,20,9,34,29
air_c6a164dd4060e960,hpg_8ce73856596a7794,2017-01-14,8,6,22,14
air_c6a164dd4060e960,hpg_8ce73856596a7794,2017-01-17,2,2,13,4
air_c6a164dd4060e960,hpg_8ce73856596a7794,2017-01-20,11,9,29,20
air_c6a164dd4060e960,hpg_8ce73856596a7794,2017-01-21,7,9,43,16
air_c6a164dd4060e960,hpg_8ce73856596a7794,2017-01-24,2,2,10,4
air_c6a164dd4060e960,hpg_8ce73856596a7794,2017-01-27,14,5,38,19
air_c6a164dd4060e960,hpg_8ce73856596a7794,2017-01-28,7,11,28,18
air_c6a164dd4060e960,hpg_8ce73856596a7794,2017-02-04,8,13,36,21
air_c6a164dd4060e960,hpg_8ce73856596a7794,2017-02-07,9,5,11,14
air_c6a164dd4060e960,hpg_8ce73856596a7794,2017-02-09,4,4,18,8
air_c6a164dd4060e960,hpg_8ce73856596a7794,2017-02-10,15,6,26,21
air_c6a164dd4060e960,hpg_8ce73856596a7794,2017-02-11,2,6,48,8
air_c6a164dd4060e960,hpg_8ce73856596a7794,2017-02-14,2,2,11,4
air_c6a164dd4060e960,hpg_8ce73856596a7794,2017-02-17,4,2,17,6
air_c6a164dd4060e960,hpg_8ce73856596a7794,2017-02-18,9,9,30,18
air_c6a164dd4060e960,hpg_8ce73856596a7794,2017-02-21,2,2,6,4
air_c6a164dd4060e960,hpg_8ce73856596a7794,2017-02-24,9,9,25,18
air_c6a164dd4060e960,hpg_8ce73856596a7794,2017-02-25,16,7,31,23
air_c6a164dd4060e960,hpg_8ce73856596a7794,2017-02-28,7,5,13,12
air_c6a164dd4060e960,hpg_8ce73856596a7794,2017-03-03,7,7,22,14
air_c6a164dd4060e960,hpg_8ce73856596a7794,2017-03-04,9,11,31,20
air_c6a164dd4060e960,hpg_8ce73856596a7794,2017-03-07,2,2,2,4
air_c6a164dd4060e960,hpg_8ce73856596a7794,2017-03-10,9,11,16,20
air_c6a164dd4060e960,hpg_8ce73856596a7794,2017-03-11,12,8,38,20
air_c6a164dd4060e960,hpg_8ce73856596a7794,2017-03-14,2,2,15,4
air_c6a164dd4060e960,hpg_8ce73856596a7794,2017-03-15,2,2,8,4
air_c6a164dd4060e960,hpg_8ce73856596a7794,2017-03-16,5,5,15,10
air_c6a164dd4060e960,hpg_8ce73856596a7794,2017-03-18,8,13,43,21
air_c6a164dd4060e960,hpg_8ce73856596a7794,2017-03-23,3,3,7,6
air_c6a164dd4060e960,hpg_8ce73856596a7794,2017-03-25,4,2,35,6
air_c6a164dd4060e960,hpg_8ce73856596a7794,2017-03-27,4,4,24,8
air_c6a164dd4060e960,hpg_8ce73856596a7794,2017-03-29,15,11,17,26
air_c6a164dd4060e960,hpg_8ce73856596a7794,2017-03-31,18,16,32,34
air_c6a164dd4060e960,hpg_8ce73856596a7794,2017-04-01,11,11,30,22
air_c6a164dd4060e960,hpg_8ce73856596a7794,2017-04-06,4,2,6,6
air_c6a164dd4060e960,hpg_8ce73856596a7794,2017-04-07,2,2,6,4
air_c6a164dd4060e960,hpg_8ce73856596a7794,2017-04-08,4,4,14,8
air_c6a164dd4060e960,hpg_8ce73856596a7794,2017-04-10,2,2,4,4
air_c6a164dd4060e960,hpg_8ce73856596a7794,2017-04-15,6,4,30,10
air_c6a164dd4060e960,hpg_8ce73856596a7794,2017-04-17,3,3,15,6
air_c6a164dd4060e960,hpg_8ce73856596a7794,2017-04-21,22,8,32,30
air_c6a164dd4060e960,hpg_8ce73856596a7794,2017-04-22,5,5,19,10
air_5f6fa1b897fe80d5,hpg_40aff6385800ebb1,2016-07-01,25,4,29,29
air_5f6fa1b897fe80d5,hpg_40aff6385800ebb1,2016-07-02,22,2,28,24
air_5f6fa1b897fe80d5,hpg_40aff6385800ebb1,2016-07-03,7,2,23,9
air_5f6fa1b897fe80d5,hpg_40aff6385800ebb1,2016-07-05,12,4,30,16
air_5f6fa1b897fe80d5,hpg_40aff6385800ebb1,2016-07-06,10,2,20,12
air_5f6fa1b897fe80d5,hpg_40aff6385800ebb1,2016-07-08,34,13,40,47
air_5f6fa1b897fe80d5,hpg_40aff6385800ebb1,2016-07-09,24,6,40,30
air_5f6fa1b897fe80d5,hpg_40aff6385800ebb1,2016-07-13,13,30,20,43
air_5f6fa1b897fe80d5,hpg_40aff6385800ebb1,2016-07-15,22,4,32,26
air_5f6fa1b897fe80d5,hpg_40aff6385800ebb1,2016-07-16,32,8,41,40
air_5f6fa1b897fe80d5,hpg_40aff6385800ebb1,2016-07-17,33,8,48,41
air_5f6fa1b897fe80d5,hpg_40aff6385800ebb1,2016-10-27,3,3,18,6
air_5f6fa1b897fe80d5,hpg_40aff6385800ebb1,2016-10-28,26,5,40,31
air_5f6fa1b897fe80d5,hpg_40aff6385800ebb1,2016-10-29,27,8,45,35
air_5f6fa1b897fe80d5,hpg_40aff6385800ebb1,2016-11-02,18,6,36,24
air_5f6fa1b897fe80d5,hpg_40aff6385800ebb1,2016-11-04,9,8,33,17
air_5f6fa1b897fe80d5,hpg_40aff6385800ebb1,2016-11-05,12,2,49,14
air_5f6fa1b897fe80d5,hpg_40aff6385800ebb1,2016-11-08,19,8,33,27
air_5f6fa1b897fe80d5,hpg_40aff6385800ebb1,2016-11-09,12,5,30,17
air_5f6fa1b897fe80d5,hpg_40aff6385800ebb1,2016-11-10,8,3,19,11
air_5f6fa1b897fe80d5,hpg_40aff6385800ebb1,2016-11-11,20,8,38,28
air_5f6fa1b897fe80d5,hpg_40aff6385800ebb1,2016-11-12,20,10,44,30
air_5f6fa1b897fe80d5,hpg_40aff6385800ebb1,2016-11-13,17,4,29,21
air_5f6fa1b897fe80d5,hpg_40aff6385800ebb1,2016-11-15,18,6,28,24
air_5f6fa1b897fe80d5,hpg_40aff6385800ebb1,2016-11-16,17,2,29,19
air_5f6fa1b897fe80d5,hpg_40aff6385800ebb1,2016-11-17,20,8,29,28
air_5f6fa1b897fe80d5,hpg_40aff6385800ebb1,2016-11-18,14,4,25,18
air_5f6fa1b897fe80d5,hpg_40aff6385800ebb1,2016-11-19,36,13,54,49
air_5f6fa1b897fe80d5,hpg_40aff6385800ebb1,2016-11-20,15,2,21,17
air_5f6fa1b897fe80d5,hpg_40aff6385800ebb1,2016-11-22,31,3,35,34
air_5f6fa1b897fe80d5,hpg_40aff6385800ebb1,2016-11-23,13,8,31,21
air_5f6fa1b897fe80d5,hpg_40aff6385800ebb1,2016-11-24,8,7,16,15
air_5f6fa1b897fe80d5,hpg_40aff6385800ebb1,2016-11-25,37,6,43,43
air_5f6fa1b897fe80d5,hpg_40aff6385800ebb1,2016-11-26,34,10,37,44
air_5f6fa1b897fe80d5,hpg_40aff6385800ebb1,2016-11-27,11,9,18,20
air_5f6fa1b897fe80d5,hpg_40aff6385800ebb1,2016-12-02,25,19,34,44
air_5f6fa1b897fe80d5,hpg_40aff6385800ebb1,2016-12-03,32,19,41,51
air_5f6fa1b897fe80d5,hpg_40aff6385800ebb1,2016-12-08,22,6,26,28
air_5f6fa1b897fe80d5,hpg_40aff6385800ebb1,2016-12-09,20,19,44,39
air_5f6fa1b897fe80d5,hpg_40aff6385800ebb1,2016-12-10,48,7,56,55
air_5f6fa1b897fe80d5,hpg_40aff6385800ebb1,2016-12-11,35,32,50,67
air_5f6fa1b897fe80d5,hpg_40aff6385800ebb1,2016-12-13,13,3,20,16
air_5f6fa1b897fe80d5,hpg_40aff6385800ebb1,2016-12-14,16,10,24,26
air_5f6fa1b897fe80d5,hpg_40aff6385800ebb1,2016-12-15,33,14,41,47
air_5f6fa1b897fe80d5,hpg_40aff6385800ebb1,2016-12-16,23,22,44,45
air_5f6fa1b897fe80d5,hpg_40aff6385800ebb1,2016-12-17,35,22,61,57
air_5f6fa1b897fe80d5,hpg_40aff6385800ebb1,2016-12-18,22,2,37,24
air_5f6fa1b897fe80d5,hpg_40aff6385800ebb1,2016-12-20,27,14,38,41
air_5f6fa1b897fe80d5,hpg_40aff6385800ebb1,2016-12-21,23,12,25,35
air_5f6fa1b897fe80d5,hpg_40aff6385800ebb1,2016-12-22,44,36,61,80
air_5f6fa1b897fe80d5,hpg_40aff6385800ebb1,2016-12-23,32,16,30,48
air_5f6fa1b897fe80d5,hpg_40aff6385800ebb1,2016-12-24,35,22,40,57
air_5f6fa1b897fe80d5,hpg_40aff6385800ebb1,2016-12-25,11,6,20,17
air_5f6fa1b897fe80d5,hpg_40aff6385800ebb1,2016-12-28,51,8,52,59
air_5f6fa1b897fe80d5,hpg_40aff6385800ebb1,2016-12-29,25,5,41,30
air_5f6fa1b897fe80d5,hpg_40aff6385800ebb1,2016-12-30,32,31,42,63
air_5f6fa1b897fe80d5,hpg_40aff6385800ebb1,2017-01-05,13,2,26,15
air_5f6fa1b897fe80d5,hpg_40aff6385800ebb1,2017-01-06,12,4,18,16
air_5f6fa1b897fe80d5,hpg_40aff6385800ebb1,2017-01-07,30,8,34,38
air_5f6fa1b897fe80d5,hpg_40aff6385800ebb1,2017-01-08,29,22,34,51
air_5f6fa1b897fe80d5,hpg_40aff6385800ebb1,2017-01-10,12,2,21,14
air_5f6fa1b897fe80d5,hpg_40aff6385800ebb1,2017-01-11,23,12,28,35
air_5f6fa1b897fe80d5,hpg_40aff6385800ebb1,2017-01-13,29,10,29,39
air_5f6fa1b897fe80d5,hpg_40aff6385800ebb1,2017-01-14,40,22,46,62
air_5f6fa1b897fe80d5,hpg_40aff6385800ebb1,2017-01-20,26,5,42,31
air_5f6fa1b897fe80d5,hpg_40aff6385800ebb1,2017-01-21,29,1,32,30
air_5f6fa1b897fe80d5,hpg_40aff6385800ebb1,2017-01-25,23,3,23,26
air_5f6fa1b897fe80d5,hpg_40aff6385800ebb1,2017-01-26,14,8,27,22
air_5f6fa1b897fe80d5,hpg_40aff6385800ebb1,2017-01-27,39,30,50,69
air_5f6fa1b897fe80d5,hpg_40aff6385800ebb1,2017-01-28,39,12,48,51
air_5f6fa1b897fe80d5,hpg_40aff6385800ebb1,2017-02-02,26,4,28,30
air_5f6fa1b897fe80d5,hpg_40aff6385800ebb1,2017-02-03,17,12,28,29
air_5f6fa1b897fe80d5,hpg_40aff6385800ebb1,2017-02-04,19,10,29,29
air_5f6fa1b897fe80d5,hpg_40aff6385800ebb1,2017-02-07,20,4,25,24
air_5f6fa1b897fe80d5,hpg_40aff6385800ebb1,2017-02-10,28,10,41,38
air_5f6fa1b897fe80d5,hpg_40aff6385800ebb1,2017-02-11,20,2,29,22
air_5f6fa1b897fe80d5,hpg_40aff6385800ebb1,2017-02-12,24,5,28,29
air_5f6fa1b897fe80d5,hpg_40aff6385800ebb1,2017-02-15,14,20,33,34
air_5f6fa1b897fe80d5,hpg_40aff6385800ebb1,2017-02-16,16,3,20,19
air_5f6fa1b897fe80d5,hpg_40aff6385800ebb1,2017-02-17,26,6,40,32
air_5f6fa1b897fe80d5,hpg_40aff6385800ebb1,2017-02-18,26,4,43,30
air_5f6fa1b897fe80d5,hpg_40aff6385800ebb1,2017-02-19,17,2,23,19
air_5f6fa1b897fe80d5,hpg_40aff6385800ebb1,2017-02-21,18,3,28,21
air_5f6fa1b897fe80d5,hpg_40aff6385800ebb1,2017-02-23,31,10,33,41
air_5f6fa1b897fe80d5,hpg_40aff6385800ebb1,2017-02-24,30,7,35,37
air_5f6fa1b897fe80d5,hpg_40aff6385800ebb1,2017-02-25,45,17,49,62
air_5f6fa1b897fe80d5,hpg_40aff6385800ebb1,2017-02-26,14,5,38,19
air_5f6fa1b897fe80d5,hpg_40aff6385800ebb1,2017-03-03,22,2,37,24
air_5f6fa1b897fe80d5,hpg_40aff6385800ebb1,2017-03-04,41,12,55,53
air_5f6fa1b897fe80d5,hpg_40aff6385800ebb1,2017-03-07,22,10,33,32
air_5f6fa1b897fe80d5,hpg_40aff6385800ebb1,2017-03-08,16,5,22,21
air_5f6fa1b897fe80d5,hpg_40aff6385800ebb1,2017-03-09,12,6,13,18
air_5f6fa1b897fe80d5,hpg_40aff6385800ebb1,2017-03-10,31,19,42,50
air_5f6fa1b897fe80d5,hpg_40aff6385800ebb1,2017-03-11,42,16,46,58
air_5f6fa1b897fe80d5,hpg_40aff6385800ebb1,2017-03-12,18,6,36,24
air_5f6fa1b897fe80d5,hpg_40aff6385800ebb1,2017-03-14,26,4,29,30
air_5f6fa1b897fe80d5,hpg_40aff6385800ebb1,2017-03-15,35,7,41,42
air_5f6fa1b897fe80d5,hpg_40aff6385800ebb1,2017-03-16,12,2,29,14
air_5f6fa1b897fe80d5,hpg_40aff6385800ebb1,2017-03-17,29,5,34,34
air_5f6fa1b897fe80d5,hpg_40aff6385800ebb1,2017-03-18,26,2,33,28
air_5f6fa1b897fe80d5,hpg_40aff6385800ebb1,2017-03-19,28,2,50,30
air_5f6fa1b897fe80d5,hpg_40aff6385800ebb1,2017-03-24,38,7,38,45
air_5f6fa1b897fe80d5,hpg_40aff6385800ebb1,2017-03-25,23,7,27,30
air_5f6fa1b897fe80d5,hpg_40aff6385800ebb1,2017-03-26,8,2,19,10
air_5f6fa1b897fe80d5,hpg_40aff6385800ebb1,2017-03-28,14,1,25,15
air_5f6fa1b897fe80d5,hpg_40aff6385800ebb1,2017-03-29,28,2,34,30
air_5f6fa1b897fe80d5,hpg_40aff6385800ebb1,2017-03-30,13,2,24,15
air_5f6fa1b897fe80d5,hpg_40aff6385800ebb1,2017-03-31,29,11,33,40
air_5f6fa1b897fe80d5,hpg_40aff6385800ebb1,2017-04-01,21,2,34,23
air_5f6fa1b897fe80d5,hpg_40aff6385800ebb1,2017-04-02,18,2,25,20
air_5f6fa1b897fe80d5,hpg_40aff6385800ebb1,2017-04-06,15,9,30,24
air_5f6fa1b897fe80d5,hpg_40aff6385800ebb1,2017-04-07,31,10,41,41
air_5f6fa1b897fe80d5,hpg_40aff6385800ebb1,2017-04-08,37,10,49,47
air_5f6fa1b897fe80d5,hpg_40aff6385800ebb1,2017-04-09,17,5,33,22
air_5f6fa1b897fe80d5,hpg_40aff6385800ebb1,2017-04-11,20,7,24,27
air_5f6fa1b897fe80d5,hpg_40aff6385800ebb1,2017-04-12,24,14,26,38
air_5f6fa1b897fe80d5,hpg_40aff6385800ebb1,2017-04-14,18,2,32,20
air_5f6fa1b897fe80d5,hpg_40aff6385800ebb1,2017-04-15,18,16,30,34
air_5f6fa1b897fe80d5,hpg_40aff6385800ebb1,2017-04-16,12,4,24,16
air_5f6fa1b897fe80d5,hpg_40aff6385800ebb1,2017-04-18,5,11,11,16
air_5f6fa1b897fe80d5,hpg_40aff6385800ebb1,2017-04-19,26,2,29,28
air_5f6fa1b897fe80d5,hpg_40aff6385800ebb1,2017-04-20,5,5,14,10
air_5f6fa1b897fe80d5,hpg_40aff6385800ebb1,2017-04-21,28,15,37,43
air_5f6fa1b897fe80d5,hpg_40aff6385800ebb1,2017-04-22,27,10,37,37
air_97159fc4e90053fe,hpg_dc52241f21eb95f6,2016-01-23,9,3,37,12
air_97159fc4e90053fe,hpg_dc52241f21eb95f6,2016-01-24,5,5,30,10
air_97159fc4e90053fe,hpg_dc52241f21eb95f6,2016-01-30,2,2,42,4
air_97159fc4e90053fe,hpg_dc52241f21eb95f6,2016-02-07,2,2,28,4
air_97159fc4e90053fe,hpg_dc52241f21eb95f6,2016-02-12,2,2,21,4
air_97159fc4e90053fe,hpg_dc52241f21eb95f6,2016-02-16,4,4,13,8
air_97159fc4e90053fe,hpg_dc52241f21eb95f6,2016-02-17,12,2,29,14
air_97159fc4e90053fe,hpg_dc52241f21eb95f6,2016-02-21,3,3,23,6
air_97159fc4e90053fe,hpg_dc52241f21eb95f6,2016-03-04,10,11,38,21
air_97159fc4e90053fe,hpg_dc52241f21eb95f6,2016-03-09,2,2,16,4
air_97159fc4e90053fe,hpg_dc52241f21eb95f6,2016-03-10,3,3,5,6
air_97159fc4e90053fe,hpg_dc52241f21eb95f6,2016-03-11,15,2,38,17
air_97159fc4e90053fe,hpg_dc52241f21eb95f6,2016-03-13,2,2,32,4
air_97159fc4e90053fe,hpg_dc52241f21eb95f6,2016-03-18,16,4,26,20
air_97159fc4e90053fe,hpg_dc52241f21eb95f6,2016-03-19,13,8,32,21
air_97159fc4e90053fe,hpg_dc52241f21eb95f6,2016-03-20,13,4,38,17
air_97159fc4e90053fe,hpg_dc52241f21eb95f6,2016-03-22,2,2,12,4
air_97159fc4e90053fe,hpg_dc52241f21eb95f6,2016-03-25,2,2,28,4
air_97159fc4e90053fe,hpg_dc52241f21eb95f6,2016-03-26,2,2,43,4
air_97159fc4e90053fe,hpg_dc52241f21eb95f6,2016-03-31,4,4,13,8
air_97159fc4e90053fe,hpg_dc52241f21eb95f6,2016-04-02,2,2,29,4
air_97159fc4e90053fe,hpg_dc52241f21eb95f6,2016-04-10,2,2,25,4
air_97159fc4e90053fe,hpg_dc52241f21eb95f6,2016-04-15,9,5,29,14
air_97159fc4e90053fe,hpg_dc52241f21eb95f6,2016-04-17,16,2,33,18
air_97159fc4e90053fe,hpg_dc52241f21eb95f6,2016-04-22,2,2,23,4
air_97159fc4e90053fe,hpg_dc52241f21eb95f6,2016-04-27,14,4,20,18
air_97159fc4e90053fe,hpg_dc52241f21eb95f6,2016-04-30,19,6,31,25
air_97159fc4e90053fe,hpg_dc52241f21eb95f6,2016-05-01,9,2,35,11
air_97159fc4e90053fe,hpg_dc52241f21eb95f6,2016-05-02,10,4,25,14
air_97159fc4e90053fe,hpg_dc52241f21eb95f6,2016-05-03,14,2,31,16
air_97159fc4e90053fe,hpg_dc52241f21eb95f6,2016-05-04,7,7,30,14
air_97159fc4e90053fe,hpg_dc52241f21eb95f6,2016-05-06,4,5,21,9
air_97159fc4e90053fe,hpg_dc52241f21eb95f6,2016-05-07,2,2,26,4
air_97159fc4e90053fe,hpg_dc52241f21eb95f6,2016-05-13,12,2,28,14
air_97159fc4e90053fe,hpg_dc52241f21eb95f6,2016-05-18,12,2,12,14
air_97159fc4e90053fe,hpg_dc52241f21eb95f6,2016-05-21,2,2,42,4
air_97159fc4e90053fe,hpg_dc52241f21eb95f6,2016-05-26,2,2,19,4
air_97159fc4e90053fe,hpg_dc52241f21eb95f6,2016-05-27,14,6,41,20
air_97159fc4e90053fe,hpg_dc52241f21eb95f6,2016-05-28,2,4,22,6
air_97159fc4e90053fe,hpg_dc52241f21eb95f6,2016-05-29,4,4,33,8
air_97159fc4e90053fe,hpg_dc52241f21eb95f6,2016-06-02,13,4,30,17
air_97159fc4e90053fe,hpg_dc52241f21eb95f6,2016-06-03,7,8,40,15
air_97159fc4e90053fe,hpg_dc52241f21eb95f6,2016-06-04,7,8,21,15
air_97159fc4e90053fe,hpg_dc52241f21eb95f6,2016-06-05,9,2,36,11
air_97159fc4e90053fe,hpg_dc52241f21eb95f6,2016-06-11,5,5,33,10
air_97159fc4e90053fe,hpg_dc52241f21eb95f6,2016-06-16,2,2,26,4
air_97159fc4e90053fe,hpg_dc52241f21eb95f6,2016-06-19,7,5,20,12
air_97159fc4e90053fe,hpg_dc52241f21eb95f6,2016-06-21,2,2,8,4
air_97159fc4e90053fe,hpg_dc52241f21eb95f6,2016-06-26,6,2,32,8
air_97159fc4e90053fe,hpg_dc52241f21eb95f6,2016-06-28,6,6,15,12
air_97159fc4e90053fe,hpg_dc52241f21eb95f6,2016-06-29,2,2,7,4
air_97159fc4e90053fe,hpg_dc52241f21eb95f6,2016-06-30,2,2,16,4
air_97159fc4e90053fe,hpg_dc52241f21eb95f6,2016-07-07,3,3,20,6
air_97159fc4e90053fe,hpg_dc52241f21eb95f6,2016-07-09,3,3,43,6
air_97159fc4e90053fe,hpg_dc52241f21eb95f6,2016-07-15,17,3,33,20
air_97159fc4e90053fe,hpg_dc52241f21eb95f6,2016-10-27,5,2,19,7
air_97159fc4e90053fe,hpg_dc52241f21eb95f6,2016-10-29,13,4,22,17
air_97159fc4e90053fe,hpg_dc52241f21eb95f6,2016-11-05,10,4,42,14
air_97159fc4e90053fe,hpg_dc52241f21eb95f6,2016-11-08,4,2,15,6
air_97159fc4e90053fe,hpg_dc52241f21eb95f6,2016-11-10,4,2,8,6
air_97159fc4e90053fe,hpg_dc52241f21eb95f6,2016-11-11,4,4,28,8
air_97159fc4e90053fe,hpg_dc52241f21eb95f6,2016-11-12,16,4,35,20
air_97159fc4e90053fe,hpg_dc52241f21eb95f6,2016-11-13,12,5,29,17
air_97159fc4e90053fe,hpg_dc52241f21eb95f6,2016-11-18,9,3,18,12
air_97159fc4e90053fe,hpg_dc52241f21eb95f6,2016-11-19,10,4,44,14
air_97159fc4e90053fe,hpg_dc52241f21eb95f6,2016-11-20,12,6,31,18
air_97159fc4e90053fe,hpg_dc52241f21eb95f6,2016-11-22,13,6,28,19
air_97159fc4e90053fe,hpg_dc52241f21eb95f6,2016-11-25,6,2,18,8
air_97159fc4e90053fe,hpg_dc52241f21eb95f6,2016-11-26,10,6,39,16
air_97159fc4e90053fe,hpg_dc52241f21eb95f6,2016-11-29,2,2,12,4
air_97159fc4e90053fe,hpg_dc52241f21eb95f6,2016-12-03,17,2,44,19
air_97159fc4e90053fe,hpg_dc52241f21eb95f6,2016-12-04,8,2,28,10
air_97159fc4e90053fe,hpg_dc52241f21eb95f6,2016-12-06,6,3,15,9
air_97159fc4e90053fe,hpg_dc52241f21eb95f6,2016-12-07,3,3,20,6
air_97159fc4e90053fe,hpg_dc52241f21eb95f6,2016-12-10,22,9,36,31
air_97159fc4e90053fe,hpg_dc52241f21eb95f6,2016-12-11,6,4,37,10
air_97159fc4e90053fe,hpg_dc52241f21eb95f6,2016-12-15,11,4,14,15
air_97159fc4e90053fe,hpg_dc52241f21eb95f6,2016-12-16,20,10,32,30
air_97159fc4e90053fe,hpg_dc52241f21eb95f6,2016-12-17,19,4,53,23
air_97159fc4e90053fe,hpg_dc52241f21eb95f6,2016-12-21,24,2,38,26
air_97159fc4e90053fe,hpg_dc52241f21eb95f6,2016-12-22,19,14,30,33
air_97159fc4e90053fe,hpg_dc52241f21eb95f6,2016-12-23,11,9,29,20
air_97159fc4e90053fe,hpg_dc52241f21eb95f6,2016-12-27,8,8,34,16
air_97159fc4e90053fe,hpg_dc52241f21eb95f6,2016-12-28,9,5,42,14
air_97159fc4e90053fe,hpg_dc52241f21eb95f6,2016-12-29,22,12,40,34
air_97159fc4e90053fe,hpg_dc52241f21eb95f6,2016-12-30,26,11,42,37
air_97159fc4e90053fe,hpg_dc52241f21eb95f6,2017-01-04,8,4,26,12
air_97159fc4e90053fe,hpg_dc52241f21eb95f6,2017-01-06,13,10,20,23
air_97159fc4e90053fe,hpg_dc52241f21eb95f6,2017-01-07,18,8,35,26
air_97159fc4e90053fe,hpg_dc52241f21eb95f6,2017-01-08,4,2,32,6
air_97159fc4e90053fe,hpg_dc52241f21eb95f6,2017-01-13,14,9,30,23
air_97159fc4e90053fe,hpg_dc52241f21eb95f6,2017-01-15,5,5,31,10
air_97159fc4e90053fe,hpg_dc52241f21eb95f6,2017-01-17,13,9,26,22
air_97159fc4e90053fe,hpg_dc52241f21eb95f6,2017-01-18,8,4,21,12
air_97159fc4e90053fe,hpg_dc52241f21eb95f6,2017-01-21,17,9,49,26
air_97159fc4e90053fe,hpg_dc52241f21eb95f6,2017-01-22,12,4,33,16
air_97159fc4e90053fe,hpg_dc52241f21eb95f6,2017-01-24,6,2,34,8
air_97159fc4e90053fe,hpg_dc52241f21eb95f6,2017-01-26,6,2,19,8
air_97159fc4e90053fe,hpg_dc52241f21eb95f6,2017-01-27,17,6,31,23
air_97159fc4e90053fe,hpg_dc52241f21eb95f6,2017-01-28,21,8,48,29
air_97159fc4e90053fe,hpg_dc52241f21eb95f6,2017-01-29,9,4,25,13
air_97159fc4e90053fe,hpg_dc52241f21eb95f6,2017-02-02,5,5,21,10
air_97159fc4e90053fe,hpg_dc52241f21eb95f6,2017-02-03,12,3,23,15
air_97159fc4e90053fe,hpg_dc52241f21eb95f6,2017-02-04,16,8,42,24
air_97159fc4e90053fe,hpg_dc52241f21eb95f6,2017-02-07,12,10,16,22
air_97159fc4e90053fe,hpg_dc52241f21eb95f6,2017-02-09,6,4,22,10
air_97159fc4e90053fe,hpg_dc52241f21eb95f6,2017-02-10,5,3,18,8
air_97159fc4e90053fe,hpg_dc52241f21eb95f6,2017-02-11,7,7,35,14
air_97159fc4e90053fe,hpg_dc52241f21eb95f6,2017-02-15,6,2,20,8
air_97159fc4e90053fe,hpg_dc52241f21eb95f6,2017-02-16,5,2,20,7
air_97159fc4e90053fe,hpg_dc52241f21eb95f6,2017-02-18,18,12,41,30
air_97159fc4e90053fe,hpg_dc52241f21eb95f6,2017-02-19,15,9,28,24
air_97159fc4e90053fe,hpg_dc52241f21eb95f6,2017-02-23,4,2,10,6
air_97159fc4e90053fe,hpg_dc52241f21eb95f6,2017-02-24,12,5,38,17
air_97159fc4e90053fe,hpg_dc52241f21eb95f6,2017-02-25,20,10,33,30
air_97159fc4e90053fe,hpg_dc52241f21eb95f6,2017-02-26,2,2,10,4
air_97159fc4e90053fe,hpg_dc52241f21eb95f6,2017-03-04,16,4,35,20
air_97159fc4e90053fe,hpg_dc52241f21eb95f6,2017-03-05,10,6,32,16
air_97159fc4e90053fe,hpg_dc52241f21eb95f6,2017-03-09,9,5,22,14
air_97159fc4e90053fe,hpg_dc52241f21eb95f6,2017-03-11,20,2,32,22
air_97159fc4e90053fe,hpg_dc52241f21eb95f6,2017-03-14,7,3,27,10
air_97159fc4e90053fe,hpg_dc52241f21eb95f6,2017-03-15,21,15,22,36
air_97159fc4e90053fe,hpg_dc52241f21eb95f6,2017-03-16,11,6,15,17
air_97159fc4e90053fe,hpg_dc52241f21eb95f6,2017-03-18,22,10,35,32
air_97159fc4e90053fe,hpg_dc52241f21eb95f6,2017-03-19,12,8,30,20
air_97159fc4e90053fe,hpg_dc52241f21eb95f6,2017-03-24,20,15,37,35
air_97159fc4e90053fe,hpg_dc52241f21eb95f6,2017-03-25,20,4,38,24
air_97159fc4e90053fe,hpg_dc52241f21eb95f6,2017-03-28,12,3,26,15
air_97159fc4e90053fe,hpg_dc52241f21eb95f6,2017-03-31,9,2,27,11
air_97159fc4e90053fe,hpg_dc52241f21eb95f6,2017-04-01,12,12,40,24
air_97159fc4e90053fe,hpg_dc52241f21eb95f6,2017-04-02,5,5,33,10
air_97159fc4e90053fe,hpg_dc52241f21eb95f6,2017-04-04,2,8,16,10
air_97159fc4e90053fe,hpg_dc52241f21eb95f6,2017-04-05,2,2,20,4
air_97159fc4e90053fe,hpg_dc52241f21eb95f6,2017-04-07,12,10,33,22
air_97159fc4e90053fe,hpg_dc52241f21eb95f6,2017-04-08,20,10,29,30
air_97159fc4e90053fe,hpg_dc52241f21eb95f6,2017-04-09,8,8,23,16
air_97159fc4e90053fe,hpg_dc52241f21eb95f6,2017-04-12,9,16,26,25
air_97159fc4e90053fe,hpg_dc52241f21eb95f6,2017-04-13,2,2,16,4
air_97159fc4e90053fe,hpg_dc52241f21eb95f6,2017-04-14,15,7,35,22
air_97159fc4e90053fe,hpg_dc52241f21eb95f6,2017-04-15,21,7,34,28
air_97159fc4e90053fe,hpg_dc52241f21eb95f6,2017-04-16,4,2,19,6
air_97159fc4e90053fe,hpg_dc52241f21eb95f6,2017-04-20,8,4,20,12
air_97159fc4e90053fe,hpg_dc52241f21eb95f6,2017-04-21,9,2,31,11
air_97159fc4e90053fe,hpg_dc52241f21eb95f6,2017-04-22,20,14,35,34
air_375a5241615b5e22,hpg_a284bcfadc49db95,2016-07-08,9,2,16,11
air_375a5241615b5e22,hpg_a284bcfadc49db95,2016-07-09,7,2,10,9
air_375a5241615b5e22,hpg_a284bcfadc49db95,2016-07-16,11,2,20,13
air_375a5241615b5e22,hpg_a284bcfadc49db95,2016-10-29,14,2,17,16
air_375a5241615b5e22,hpg_a284bcfadc49db95,2016-11-10,16,2,22,18
air_375a5241615b5e22,hpg_a284bcfadc49db95,2016-11-26,7,2,10,9
air_375a5241615b5e22,hpg_a284bcfadc49db95,2016-12-09,6,4,12,10
air_375a5241615b5e22,hpg_a284bcfadc49db95,2016-12-10,11,6,23,17
air_375a5241615b5e22,hpg_a284bcfadc49db95,2016-12-15,11,11,11,22
air_375a5241615b5e22,hpg_a284bcfadc49db95,2016-12-16,2,2,15,4
air_375a5241615b5e22,hpg_a284bcfadc49db95,2016-12-17,12,10,21,22
air_375a5241615b5e22,hpg_a284bcfadc49db95,2016-12-21,4,4,11,8
air_375a5241615b5e22,hpg_a284bcfadc49db95,2016-12-22,5,10,17,15
air_375a5241615b5e22,hpg_a284bcfadc49db95,2016-12-23,10,4,16,14
air_375a5241615b5e22,hpg_a284bcfadc49db95,2016-12-24,6,4,23,10
air_375a5241615b5e22,hpg_a284bcfadc49db95,2016-12-29,4,4,10,8
air_375a5241615b5e22,hpg_a284bcfadc49db95,2016-12-30,7,7,20,14
air_375a5241615b5e22,hpg_a284bcfadc49db95,2017-01-13,7,2,8,9
air_375a5241615b5e22,hpg_a284bcfadc49db95,2017-01-16,2,2,9,4
air_375a5241615b5e22,hpg_a284bcfadc49db95,2017-01-28,8,2,14,10
air_375a5241615b5e22,hpg_a284bcfadc49db95,2017-02-03,8,2,12,10
air_375a5241615b5e22,hpg_a284bcfadc49db95,2017-02-11,3,3,15,6
air_375a5241615b5e22,hpg_a284bcfadc49db95,2017-02-18,2,2,7,4
air_375a5241615b5e22,hpg_a284bcfadc49db95,2017-02-24,6,3,15,9
air_375a5241615b5e22,hpg_a284bcfadc49db95,2017-03-01,6,2,12,8
air_375a5241615b5e22,hpg_a284bcfadc49db95,2017-03-11,3,3,8,6
air_375a5241615b5e22,hpg_a284bcfadc49db95,2017-03-17,6,4,15,10
air_375a5241615b5e22,hpg_a284bcfadc49db95,2017-03-18,8,2,11,10
air_375a5241615b5e22,hpg_a284bcfadc49db95,2017-03-22,2,2,3,4
air_375a5241615b5e22,hpg_a284bcfadc49db95,2017-03-25,9,2,15,11
air_375a5241615b5e22,hpg_a284bcfadc49db95,2017-03-31,6,3,10,9
air_375a5241615b5e22,hpg_a284bcfadc49db95,2017-04-03,2,2,10,4
air_375a5241615b5e22,hpg_a284bcfadc49db95,2017-04-21,1,1,5,2
air_de88770300008624,hpg_a786d63904735f58,2016-10-28,3,3,16,6
air_de88770300008624,hpg_a786d63904735f58,2016-10-29,23,2,62,25
air_de88770300008624,hpg_a786d63904735f58,2016-11-02,16,3,23,19
air_de88770300008624,hpg_a786d63904735f58,2016-11-04,4,4,13,8
air_de88770300008624,hpg_a786d63904735f58,2016-11-06,2,2,6,4
air_de88770300008624,hpg_a786d63904735f58,2016-11-11,11,7,15,18
air_de88770300008624,hpg_a786d63904735f58,2016-11-12,18,11,22,29
air_de88770300008624,hpg_a786d63904735f58,2016-11-13,6,6,6,12
air_de88770300008624,hpg_a786d63904735f58,2016-11-18,5,2,18,7
air_de88770300008624,hpg_a786d63904735f58,2016-11-20,10,10,13,20
air_de88770300008624,hpg_a786d63904735f58,2016-11-26,32,5,32,37
air_de88770300008624,hpg_a786d63904735f58,2016-11-28,4,4,9,8
air_de88770300008624,hpg_a786d63904735f58,2016-11-29,2,2,9,4
air_de88770300008624,hpg_a786d63904735f58,2016-12-02,5,5,17,10
air_de88770300008624,hpg_a786d63904735f58,2016-12-06,2,2,20,4
air_de88770300008624,hpg_a786d63904735f58,2016-12-09,28,33,34,61
air_de88770300008624,hpg_a786d63904735f58,2016-12-10,24,25,59,49
air_de88770300008624,hpg_a786d63904735f58,2016-12-16,2,37,39,39
air_de88770300008624,hpg_a786d63904735f58,2016-12-17,26,53,52,79
air_de88770300008624,hpg_a786d63904735f58,2016-12-18,4,4,13,8
air_de88770300008624,hpg_a786d63904735f58,2016-12-20,12,20,12,32
air_de88770300008624,hpg_a786d63904735f58,2016-12-21,38,69,42,107
air_de88770300008624,hpg_a786d63904735f58,2016-12-22,29,20,41,49
air_de88770300008624,hpg_a786d63904735f58,2016-12-24,8,6,10,14
air_de88770300008624,hpg_a786d63904735f58,2016-12-27,7,7,16,14
air_de88770300008624,hpg_a786d63904735f58,2016-12-28,34,25,50,59
air_de88770300008624,hpg_a786d63904735f58,2016-12-29,28,21,28,49
air_de88770300008624,hpg_a786d63904735f58,2016-12-30,6,41,36,47
air_de88770300008624,hpg_a786d63904735f58,2017-01-02,36,8,54,44
air_de88770300008624,hpg_a786d63904735f58,2017-01-06,24,8,55,32
air_de88770300008624,hpg_a786d63904735f58,2017-01-07,25,10,45,35
air_de88770300008624,hpg_a786d63904735f58,2017-01-20,30,15,37,45
air_de88770300008624,hpg_a786d63904735f58,2017-01-21,25,16,37,41
air_de88770300008624,hpg_a786d63904735f58,2017-01-23,3,3,6,6
air_de88770300008624,hpg_a786d63904735f58,2017-01-27,12,14,37,26
air_de88770300008624,hpg_a786d63904735f58,2017-02-01,8,12,26,20
air_de88770300008624,hpg_a786d63904735f58,2017-02-04,24,4,32,28
air_de88770300008624,hpg_a786d63904735f58,2017-02-08,3,3,10,6
air_de88770300008624,hpg_a786d63904735f58,2017-02-09,9,9,9,18
air_de88770300008624,hpg_a786d63904735f58,2017-02-11,34,19,48,53
air_de88770300008624,hpg_a786d63904735f58,2017-02-13,4,2,9,6
air_de88770300008624,hpg_a786d63904735f58,2017-02-15,6,6,9,12
air_de88770300008624,hpg_a786d63904735f58,2017-02-17,7,2,33,9
air_de88770300008624,hpg_a786d63904735f58,2017-02-20,2,2,3,4
air_de88770300008624,hpg_a786d63904735f58,2017-02-21,4,4,8,8
air_de88770300008624,hpg_a786d63904735f58,2017-02-24,15,4,32,19
air_de88770300008624,hpg_a786d63904735f58,2017-03-03,16,4,29,20
air_de88770300008624,hpg_a786d63904735f58,2017-03-04,4,10,52,14
air_de88770300008624,hpg_a786d63904735f58,2017-03-06,2,2,10,4
air_de88770300008624,hpg_a786d63904735f58,2017-03-10,43,28,45,71
air_de88770300008624,hpg_a786d63904735f58,2017-03-11,26,14,42,40
air_de88770300008624,hpg_a786d63904735f58,2017-03-13,7,2,10,9
air_de88770300008624,hpg_a786d63904735f58,2017-03-15,6,4,12,10
air_de88770300008624,hpg_a786d63904735f58,2017-03-18,12,17,29,29
air_de88770300008624,hpg_a786d63904735f58,2017-03-19,9,9,23,18
air_de88770300008624,hpg_a786d63904735f58,2017-03-20,8,8,10,16
air_de88770300008624,hpg_a786d63904735f58,2017-03-22,11,11,23,22
air_de88770300008624,hpg_a786d63904735f58,2017-03-24,38,25,60,63
air_de88770300008624,hpg_a786d63904735f58,2017-03-25,33,16,30,49
air_de88770300008624,hpg_a786d63904735f58,2017-03-27,7,7,12,14
air_de88770300008624,hpg_a786d63904735f58,2017-03-29,12,5,20,17
air_de88770300008624,hpg_a786d63904735f58,2017-03-31,19,17,36,36
air_de88770300008624,hpg_a786d63904735f58,2017-04-01,16,10,24,26
air_de88770300008624,hpg_a786d63904735f58,2017-04-02,5,5,8,10
air_de88770300008624,hpg_a786d63904735f58,2017-04-04,3,3,5,6
air_de88770300008624,hpg_a786d63904735f58,2017-04-07,16,6,24,22
air_de88770300008624,hpg_a786d63904735f58,2017-04-08,33,12,25,45
air_de88770300008624,hpg_a786d63904735f58,2017-04-11,7,7,16,14
air_de88770300008624,hpg_a786d63904735f58,2017-04-15,5,8,21,13
air_de88770300008624,hpg_a786d63904735f58,2017-04-17,6,6,8,12
air_de88770300008624,hpg_a786d63904735f58,2017-04-21,30,18,47,48
air_de88770300008624,hpg_a786d63904735f58,2017-04-22,18,21,36,39
air_bedd35489e666605,hpg_8f5331198ed1781d,2016-11-05,13,5,18,18
air_bedd35489e666605,hpg_8f5331198ed1781d,2016-11-18,20,6,66,26
air_bedd35489e666605,hpg_8f5331198ed1781d,2016-11-19,16,3,28,19
air_bedd35489e666605,hpg_8f5331198ed1781d,2016-11-29,10,8,42,18
air_bedd35489e666605,hpg_8f5331198ed1781d,2016-12-20,25,10,53,35
air_bedd35489e666605,hpg_8f5331198ed1781d,2016-12-23,8,2,14,10
air_bedd35489e666605,hpg_8f5331198ed1781d,2016-12-28,22,11,24,33
air_bedd35489e666605,hpg_8f5331198ed1781d,2017-01-19,2,2,14,4
air_bedd35489e666605,hpg_8f5331198ed1781d,2017-01-26,8,2,37,10
air_bedd35489e666605,hpg_8f5331198ed1781d,2017-02-01,15,7,55,22
air_bedd35489e666605,hpg_8f5331198ed1781d,2017-02-10,17,6,46,23
air_bedd35489e666605,hpg_8f5331198ed1781d,2017-02-18,25,2,29,27
air_bedd35489e666605,hpg_8f5331198ed1781d,2017-02-22,5,2,35,7
air_bedd35489e666605,hpg_8f5331198ed1781d,2017-02-25,4,2,22,6
air_bedd35489e666605,hpg_8f5331198ed1781d,2017-03-10,14,2,81,16
air_bedd35489e666605,hpg_8f5331198ed1781d,2017-03-27,9,4,40,13
air_bedd35489e666605,hpg_8f5331198ed1781d,2017-03-29,15,5,52,20
air_bedd35489e666605,hpg_8f5331198ed1781d,2017-03-31,13,2,52,15
air_bedd35489e666605,hpg_8f5331198ed1781d,2017-04-07,17,8,43,25
air_a546cbf478a8b6e4,hpg_7f25667859876495,2016-09-05,4,4,14,8
air_a546cbf478a8b6e4,hpg_7f25667859876495,2016-09-16,2,14,32,16
air_a546cbf478a8b6e4,hpg_7f25667859876495,2016-11-16,2,2,21,4
air_a546cbf478a8b6e4,hpg_7f25667859876495,2017-03-18,2,4,32,6
air_2a485b92210c98b5,hpg_dd709beb78198f38,2017-01-20,18,3,5,21
air_2a485b92210c98b5,hpg_dd709beb78198f38,2017-01-28,40,9,41,49
air_2a485b92210c98b5,hpg_dd709beb78198f38,2017-02-01,2,2,19,4
air_2a485b92210c98b5,hpg_dd709beb78198f38,2017-02-02,2,4,28,6
air_2a485b92210c98b5,hpg_dd709beb78198f38,2017-02-04,22,29,41,51
air_2a485b92210c98b5,hpg_dd709beb78198f38,2017-02-08,2,2,10,4
air_2a485b92210c98b5,hpg_dd709beb78198f38,2017-02-09,4,2,11,6
air_2a485b92210c98b5,hpg_dd709beb78198f38,2017-02-12,12,7,44,19
air_2a485b92210c98b5,hpg_dd709beb78198f38,2017-02-15,6,6,34,12
air_2a485b92210c98b5,hpg_dd709beb78198f38,2017-02-18,20,16,29,36
air_2a485b92210c98b5,hpg_dd709beb78198f38,2017-02-21,7,3,13,10
air_2a485b92210c98b5,hpg_dd709beb78198f38,2017-02-23,4,4,13,8
air_2a485b92210c98b5,hpg_dd709beb78198f38,2017-02-25,69,7,94,76
air_2a485b92210c98b5,hpg_dd709beb78198f38,2017-02-28,3,7,3,10
air_2a485b92210c98b5,hpg_dd709beb78198f38,2017-03-04,35,5,10,40
air_2a485b92210c98b5,hpg_dd709beb78198f38,2017-03-11,6,6,54,12
air_2a485b92210c98b5,hpg_dd709beb78198f38,2017-03-17,47,32,10,79
air_2a485b92210c98b5,hpg_dd709beb78198f38,2017-03-18,27,3,31,30
air_2a485b92210c98b5,hpg_dd709beb78198f38,2017-03-19,33,48,53,81
air_2a485b92210c98b5,hpg_dd709beb78198f38,2017-03-24,2,5,13,7
air_2a485b92210c98b5,hpg_dd709beb78198f38,2017-03-29,6,7,22,13
air_2a485b92210c98b5,hpg_dd709beb78198f38,2017-03-30,6,6,21,12
air_2a485b92210c98b5,hpg_dd709beb78198f38,2017-04-08,8,4,16,12
air_2a485b92210c98b5,hpg_dd709beb78198f38,2017-04-12,5,5,11,10
air_2a485b92210c98b5,hpg_dd709beb78198f38,2017-04-18,2,4,10,6
air_2a485b92210c98b5,hpg_dd709beb78198f38,2017-04-19,7,1,11,8
air_2a485b92210c98b5,hpg_dd709beb78198f38,2017-04-20,4,3,10,7
air_2a485b92210c98b5,hpg_dd709beb78198f38,2017-04-21,4,4,20,8
air_af63df35857b16e6,hpg_71765891f7a4ac62,2016-10-27,7,3,21,10
air_af63df35857b16e6,hpg_71765891f7a4ac62,2016-10-28,25,11,32,36
air_af63df35857b16e6,hpg_71765891f7a4ac62,2016-10-29,19,2,30,21
air_af63df35857b16e6,hpg_71765891f7a4ac62,2016-10-31,6,6,8,12
air_af63df35857b16e6,hpg_71765891f7a4ac62,2016-11-03,8,2,28,10
air_af63df35857b16e6,hpg_71765891f7a4ac62,2016-11-04,23,11,16,34
air_af63df35857b16e6,hpg_71765891f7a4ac62,2016-11-06,10,4,24,14
air_af63df35857b16e6,hpg_71765891f7a4ac62,2016-11-12,35,11,42,46
air_af63df35857b16e6,hpg_71765891f7a4ac62,2016-11-23,12,2,23,14
air_af63df35857b16e6,hpg_71765891f7a4ac62,2016-12-03,29,2,40,31
air_af63df35857b16e6,hpg_71765891f7a4ac62,2016-12-10,29,2,40,31
air_af63df35857b16e6,hpg_71765891f7a4ac62,2016-12-23,18,3,37,21
air_af63df35857b16e6,hpg_71765891f7a4ac62,2017-01-08,23,2,35,25
air_af63df35857b16e6,hpg_71765891f7a4ac62,2017-02-08,12,2,22,14
air_af63df35857b16e6,hpg_71765891f7a4ac62,2017-02-10,16,2,27,18
air_af63df35857b16e6,hpg_71765891f7a4ac62,2017-02-26,21,2,32,23
air_af63df35857b16e6,hpg_71765891f7a4ac62,2017-03-03,15,2,26,17
air_af63df35857b16e6,hpg_71765891f7a4ac62,2017-03-04,23,2,30,25
air_af63df35857b16e6,hpg_71765891f7a4ac62,2017-03-08,17,5,17,22
air_af63df35857b16e6,hpg_71765891f7a4ac62,2017-04-15,34,4,34,38
air_af63df35857b16e6,hpg_71765891f7a4ac62,2017-04-21,31,5,36,36
air_db80363d35f10926,hpg_878cc70b1abc76f7,2016-01-01,5,4,8,9
air_db80363d35f10926,hpg_878cc70b1abc76f7,2016-01-02,34,2,94,36
air_db80363d35f10926,hpg_878cc70b1abc76f7,2016-01-03,17,6,69,23
air_db80363d35f10926,hpg_878cc70b1abc76f7,2016-01-06,5,3,4,8
air_db80363d35f10926,hpg_878cc70b1abc76f7,2016-01-11,2,2,25,4
air_db80363d35f10926,hpg_878cc70b1abc76f7,2016-01-12,3,3,16,6
air_db80363d35f10926,hpg_878cc70b1abc76f7,2016-01-15,24,9,27,33
air_db80363d35f10926,hpg_878cc70b1abc76f7,2016-01-16,23,3,47,26
air_db80363d35f10926,hpg_878cc70b1abc76f7,2016-01-18,2,2,2,4
air_db80363d35f10926,hpg_878cc70b1abc76f7,2016-01-22,35,21,3,56
air_db80363d35f10926,hpg_878cc70b1abc76f7,2016-01-23,13,2,107,15
air_db80363d35f10926,hpg_878cc70b1abc76f7,2016-01-29,4,2,6,6
air_db80363d35f10926,hpg_878cc70b1abc76f7,2016-02-05,15,8,20,23
air_db80363d35f10926,hpg_878cc70b1abc76f7,2016-02-07,22,10,40,32
air_db80363d35f10926,hpg_878cc70b1abc76f7,2016-02-08,4,2,7,6
air_db80363d35f10926,hpg_878cc70b1abc76f7,2016-02-10,12,10,25,22
air_db80363d35f10926,hpg_878cc70b1abc76f7,2016-02-11,15,13,18,28
air_db80363d35f10926,hpg_878cc70b1abc76f7,2016-02-12,6,2,6,8
air_db80363d35f10926,hpg_878cc70b1abc76f7,2016-02-13,34,8,43,42
air_db80363d35f10926,hpg_878cc70b1abc76f7,2016-02-20,36,11,43,47
air_db80363d35f10926,hpg_878cc70b1abc76f7,2016-02-25,7,2,4,9
air_db80363d35f10926,hpg_878cc70b1abc76f7,2016-02-28,27,17,42,44
air_db80363d35f10926,hpg_878cc70b1abc76f7,2016-03-11,26,9,52,35
air_db80363d35f10926,hpg_878cc70b1abc76f7,2016-03-12,51,8,62,59
air_db80363d35f10926,hpg_878cc70b1abc76f7,2016-03-15,6,3,19,9
air_db80363d35f10926,hpg_878cc70b1abc76f7,2016-03-16,2,2,16,4
air_db80363d35f10926,hpg_878cc70b1abc76f7,2016-03-17,16,6,37,22
air_db80363d35f10926,hpg_878cc70b1abc76f7,2016-03-18,35,11,43,46
air_db80363d35f10926,hpg_878cc70b1abc76f7,2016-03-24,17,17,9,34
air_db80363d35f10926,hpg_878cc70b1abc76f7,2016-03-25,56,2,62,58
air_db80363d35f10926,hpg_878cc70b1abc76f7,2016-03-26,48,20,82,68
air_db80363d35f10926,hpg_878cc70b1abc76f7,2016-03-30,20,15,27,35
air_db80363d35f10926,hpg_878cc70b1abc76f7,2016-04-09,37,10,21,47
air_db80363d35f10926,hpg_878cc70b1abc76f7,2016-04-16,50,50,62,100
air_db80363d35f10926,hpg_878cc70b1abc76f7,2016-04-22,50,4,70,54
air_db80363d35f10926,hpg_878cc70b1abc76f7,2016-04-23,22,4,42,26
air_db80363d35f10926,hpg_878cc70b1abc76f7,2016-04-26,15,15,23,30
air_db80363d35f10926,hpg_878cc70b1abc76f7,2016-04-27,4,4,9,8
air_db80363d35f10926,hpg_878cc70b1abc76f7,2016-04-30,15,6,36,21
air_db80363d35f10926,hpg_878cc70b1abc76f7,2016-05-04,6,6,26,12
air_db80363d35f10926,hpg_878cc70b1abc76f7,2016-05-07,4,2,29,6
air_db80363d35f10926,hpg_878cc70b1abc76f7,2016-05-14,44,19,83,63
air_db80363d35f10926,hpg_878cc70b1abc76f7,2016-05-15,2,2,14,4
air_db80363d35f10926,hpg_878cc70b1abc76f7,2016-05-21,8,8,35,16
air_db80363d35f10926,hpg_878cc70b1abc76f7,2016-05-28,30,21,41,51
air_db80363d35f10926,hpg_878cc70b1abc76f7,2016-06-03,4,4,6,8
air_db80363d35f10926,hpg_878cc70b1abc76f7,2016-06-04,30,30,46,60
air_db80363d35f10926,hpg_878cc70b1abc76f7,2016-06-23,6,3,10,9
air_db80363d35f10926,hpg_878cc70b1abc76f7,2016-06-25,51,4,28,55
air_db80363d35f10926,hpg_878cc70b1abc76f7,2016-06-30,13,10,20,23
air_db80363d35f10926,hpg_878cc70b1abc76f7,2016-07-01,37,8,53,45
air_db80363d35f10926,hpg_878cc70b1abc76f7,2016-07-16,7,7,12,14
air_db80363d35f10926,hpg_878cc70b1abc76f7,2016-07-23,49,14,56,63
air_db80363d35f10926,hpg_878cc70b1abc76f7,2016-10-28,14,3,3,17
air_db80363d35f10926,hpg_878cc70b1abc76f7,2016-10-29,52,37,86,89
air_db80363d35f10926,hpg_878cc70b1abc76f7,2016-10-30,5,2,34,7
air_db80363d35f10926,hpg_878cc70b1abc76f7,2016-10-31,3,3,7,6
air_db80363d35f10926,hpg_878cc70b1abc76f7,2016-11-03,44,2,30,46
air_db80363d35f10926,hpg_878cc70b1abc76f7,2016-11-04,5,2,50,7
air_db80363d35f10926,hpg_878cc70b1abc76f7,2016-11-05,24,16,21,40
air_db80363d35f10926,hpg_878cc70b1abc76f7,2016-11-11,6,3,14,9
air_db80363d35f10926,hpg_878cc70b1abc76f7,2016-11-17,7,7,4,14
air_db80363d35f10926,hpg_878cc70b1abc76f7,2016-11-19,23,9,45,32
air_db80363d35f10926,hpg_878cc70b1abc76f7,2016-11-22,3,3,10,6
air_db80363d35f10926,hpg_878cc70b1abc76f7,2016-11-23,6,4,10,10
air_db80363d35f10926,hpg_878cc70b1abc76f7,2016-11-25,15,6,31,21
air_db80363d35f10926,hpg_878cc70b1abc76f7,2016-11-26,32,9,54,41
air_db80363d35f10926,hpg_878cc70b1abc76f7,2016-12-03,58,50,65,108
air_db80363d35f10926,hpg_878cc70b1abc76f7,2016-12-04,8,3,37,11
air_db80363d35f10926,hpg_878cc70b1abc76f7,2016-12-06,4,2,12,6
air_db80363d35f10926,hpg_878cc70b1abc76f7,2016-12-09,64,18,66,82
air_db80363d35f10926,hpg_878cc70b1abc76f7,2016-12-10,52,27,55,79
air_db80363d35f10926,hpg_878cc70b1abc76f7,2016-12-15,2,2,11,4
air_db80363d35f10926,hpg_878cc70b1abc76f7,2016-12-16,65,11,70,76
air_db80363d35f10926,hpg_878cc70b1abc76f7,2016-12-17,63,31,89,94
air_db80363d35f10926,hpg_878cc70b1abc76f7,2016-12-19,15,6,24,21
air_db80363d35f10926,hpg_878cc70b1abc76f7,2016-12-20,31,3,6,34
air_db80363d35f10926,hpg_878cc70b1abc76f7,2016-12-22,77,34,75,111
air_db80363d35f10926,hpg_878cc70b1abc76f7,2016-12-24,13,4,31,17
air_db80363d35f10926,hpg_878cc70b1abc76f7,2016-12-27,12,9,21,21
air_db80363d35f10926,hpg_878cc70b1abc76f7,2016-12-28,29,4,33,33
air_db80363d35f10926,hpg_878cc70b1abc76f7,2016-12-29,74,27,70,101
air_db80363d35f10926,hpg_878cc70b1abc76f7,2016-12-30,59,24,90,83
air_db80363d35f10926,hpg_878cc70b1abc76f7,2016-12-31,11,15,62,26
air_db80363d35f10926,hpg_878cc70b1abc76f7,2017-01-02,42,19,52,61
air_db80363d35f10926,hpg_878cc70b1abc76f7,2017-01-03,40,14,87,54
air_db80363d35f10926,hpg_878cc70b1abc76f7,2017-01-06,5,3,13,8
air_db80363d35f10926,hpg_878cc70b1abc76f7,2017-01-07,51,12,67,63
air_db80363d35f10926,hpg_878cc70b1abc76f7,2017-01-10,14,4,38,18
air_db80363d35f10926,hpg_878cc70b1abc76f7,2017-01-12,10,10,14,20
air_db80363d35f10926,hpg_878cc70b1abc76f7,2017-01-13,45,12,45,57
air_db80363d35f10926,hpg_878cc70b1abc76f7,2017-01-14,34,18,73,52
air_db80363d35f10926,hpg_878cc70b1abc76f7,2017-01-16,7,2,14,9
air_db80363d35f10926,hpg_878cc70b1abc76f7,2017-01-20,27,11,33,38
air_db80363d35f10926,hpg_878cc70b1abc76f7,2017-01-21,23,15,37,38
air_db80363d35f10926,hpg_878cc70b1abc76f7,2017-01-27,13,8,13,21
air_db80363d35f10926,hpg_878cc70b1abc76f7,2017-01-28,61,33,75,94
air_db80363d35f10926,hpg_878cc70b1abc76f7,2017-01-30,23,8,29,31
air_db80363d35f10926,hpg_878cc70b1abc76f7,2017-01-31,3,3,16,6
air_db80363d35f10926,hpg_878cc70b1abc76f7,2017-02-03,35,2,19,37
air_db80363d35f10926,hpg_878cc70b1abc76f7,2017-02-04,15,4,45,19
air_db80363d35f10926,hpg_878cc70b1abc76f7,2017-02-06,22,7,14,29
air_db80363d35f10926,hpg_878cc70b1abc76f7,2017-02-10,33,19,17,52
air_db80363d35f10926,hpg_878cc70b1abc76f7,2017-02-11,45,2,67,47
air_db80363d35f10926,hpg_878cc70b1abc76f7,2017-02-14,2,4,23,6
air_db80363d35f10926,hpg_878cc70b1abc76f7,2017-02-15,4,4,7,8
air_db80363d35f10926,hpg_878cc70b1abc76f7,2017-02-17,12,3,23,15
air_db80363d35f10926,hpg_878cc70b1abc76f7,2017-02-18,26,15,44,41
air_db80363d35f10926,hpg_878cc70b1abc76f7,2017-02-23,24,2,31,26
air_db80363d35f10926,hpg_878cc70b1abc76f7,2017-02-24,13,12,18,25
air_db80363d35f10926,hpg_878cc70b1abc76f7,2017-02-25,79,48,84,127
air_db80363d35f10926,hpg_878cc70b1abc76f7,2017-02-27,11,2,26,13
air_db80363d35f10926,hpg_878cc70b1abc76f7,2017-02-28,17,5,20,22
air_db80363d35f10926,hpg_878cc70b1abc76f7,2017-03-03,26,26,29,52
air_db80363d35f10926,hpg_878cc70b1abc76f7,2017-03-04,50,13,65,63
air_db80363d35f10926,hpg_878cc70b1abc76f7,2017-03-07,15,15,8,30
air_db80363d35f10926,hpg_878cc70b1abc76f7,2017-03-09,9,3,10,12
air_db80363d35f10926,hpg_878cc70b1abc76f7,2017-03-10,39,6,44,45
air_db80363d35f10926,hpg_878cc70b1abc76f7,2017-03-11,69,58,88,127
air_db80363d35f10926,hpg_878cc70b1abc76f7,2017-03-14,4,4,8,8
air_db80363d35f10926,hpg_878cc70b1abc76f7,2017-03-17,72,41,98,113
air_db80363d35f10926,hpg_878cc70b1abc76f7,2017-03-18,42,16,44,58
air_db80363d35f10926,hpg_878cc70b1abc76f7,2017-03-19,54,137,88,191
air_db80363d35f10926,hpg_878cc70b1abc76f7,2017-03-20,23,23,32,46
air_db80363d35f10926,hpg_878cc70b1abc76f7,2017-03-22,11,7,9,18
air_db80363d35f10926,hpg_878cc70b1abc76f7,2017-03-23,10,2,20,12
air_db80363d35f10926,hpg_878cc70b1abc76f7,2017-03-24,80,17,106,97
air_db80363d35f10926,hpg_878cc70b1abc76f7,2017-03-25,93,16,43,109
air_db80363d35f10926,hpg_878cc70b1abc76f7,2017-03-26,3,3,62,6
air_db80363d35f10926,hpg_878cc70b1abc76f7,2017-03-28,4,4,4,8
air_db80363d35f10926,hpg_878cc70b1abc76f7,2017-03-29,40,19,53,59
air_db80363d35f10926,hpg_878cc70b1abc76f7,2017-03-31,37,3,49,40
air_db80363d35f10926,hpg_878cc70b1abc76f7,2017-04-01,31,4,31,35
air_db80363d35f10926,hpg_878cc70b1abc76f7,2017-04-04,29,29,32,58
air_db80363d35f10926,hpg_878cc70b1abc76f7,2017-04-08,33,9,44,42
air_db80363d35f10926,hpg_878cc70b1abc76f7,2017-04-12,14,14,10,28
air_db80363d35f10926,hpg_878cc70b1abc76f7,2017-04-14,41,13,43,54
air_db80363d35f10926,hpg_878cc70b1abc76f7,2017-04-15,44,8,59,52
air_db80363d35f10926,hpg_878cc70b1abc76f7,2017-04-21,51,33,62,84
air_db80363d35f10926,hpg_878cc70b1abc76f7,2017-04-22,38,14,52,52
air_683371d9baabf410,hpg_7dae95f9d3db1734,2016-03-06,9,4,21,13
air_683371d9baabf410,hpg_7dae95f9d3db1734,2016-03-20,35,10,35,45
air_683371d9baabf410,hpg_7dae95f9d3db1734,2016-03-24,14,9,47,23
air_683371d9baabf410,hpg_7dae95f9d3db1734,2016-03-26,6,14,22,20
air_683371d9baabf410,hpg_7dae95f9d3db1734,2016-10-28,30,22,40,52
air_683371d9baabf410,hpg_7dae95f9d3db1734,2016-10-29,16,2,23,18
air_683371d9baabf410,hpg_7dae95f9d3db1734,2016-10-30,49,3,51,52
air_683371d9baabf410,hpg_7dae95f9d3db1734,2016-11-03,33,5,45,38
air_683371d9baabf410,hpg_7dae95f9d3db1734,2016-11-06,49,8,50,57
air_683371d9baabf410,hpg_7dae95f9d3db1734,2016-11-09,16,5,30,21
air_683371d9baabf410,hpg_7dae95f9d3db1734,2016-11-11,8,2,24,10
air_683371d9baabf410,hpg_7dae95f9d3db1734,2016-11-12,24,2,40,26
air_683371d9baabf410,hpg_7dae95f9d3db1734,2016-11-16,2,2,18,4
air_683371d9baabf410,hpg_7dae95f9d3db1734,2016-11-17,34,27,47,61
air_683371d9baabf410,hpg_7dae95f9d3db1734,2016-11-18,2,2,19,4
air_683371d9baabf410,hpg_7dae95f9d3db1734,2016-11-19,49,25,64,74
air_683371d9baabf410,hpg_7dae95f9d3db1734,2016-11-20,19,11,31,30
air_683371d9baabf410,hpg_7dae95f9d3db1734,2016-11-24,10,4,19,14
air_683371d9baabf410,hpg_7dae95f9d3db1734,2016-11-25,13,4,26,17
air_683371d9baabf410,hpg_7dae95f9d3db1734,2016-11-26,49,20,49,69
air_683371d9baabf410,hpg_7dae95f9d3db1734,2016-11-27,37,2,37,39
air_683371d9baabf410,hpg_7dae95f9d3db1734,2016-11-30,10,10,33,20
air_683371d9baabf410,hpg_7dae95f9d3db1734,2016-12-01,23,2,33,25
air_683371d9baabf410,hpg_7dae95f9d3db1734,2016-12-02,58,4,58,62
air_683371d9baabf410,hpg_7dae95f9d3db1734,2016-12-03,30,6,33,36
air_683371d9baabf410,hpg_7dae95f9d3db1734,2016-12-04,38,2,38,40
air_683371d9baabf410,hpg_7dae95f9d3db1734,2016-12-06,12,12,26,24
air_683371d9baabf410,hpg_7dae95f9d3db1734,2016-12-09,20,5,28,25
air_683371d9baabf410,hpg_7dae95f9d3db1734,2016-12-10,45,7,45,52
air_683371d9baabf410,hpg_7dae95f9d3db1734,2016-12-11,34,12,43,46
air_683371d9baabf410,hpg_7dae95f9d3db1734,2016-12-13,30,15,44,45
air_683371d9baabf410,hpg_7dae95f9d3db1734,2016-12-14,18,6,29,24
air_683371d9baabf410,hpg_7dae95f9d3db1734,2016-12-15,15,28,38,43
air_683371d9baabf410,hpg_7dae95f9d3db1734,2016-12-17,52,10,53,62
air_683371d9baabf410,hpg_7dae95f9d3db1734,2016-12-18,51,28,51,79
air_683371d9baabf410,hpg_7dae95f9d3db1734,2016-12-20,31,6,38,37
air_683371d9baabf410,hpg_7dae95f9d3db1734,2016-12-21,18,5,44,23
air_683371d9baabf410,hpg_7dae95f9d3db1734,2016-12-22,37,2,43,39
air_683371d9baabf410,hpg_7dae95f9d3db1734,2016-12-24,31,10,37,41
air_683371d9baabf410,hpg_7dae95f9d3db1734,2016-12-25,20,6,25,26
air_683371d9baabf410,hpg_7dae95f9d3db1734,2016-12-28,42,13,56,55
air_683371d9baabf410,hpg_7dae95f9d3db1734,2016-12-29,42,12,46,54
air_683371d9baabf410,hpg_7dae95f9d3db1734,2017-01-07,24,12,34,36
air_683371d9baabf410,hpg_7dae95f9d3db1734,2017-01-08,32,4,41,36
air_683371d9baabf410,hpg_7dae95f9d3db1734,2017-01-10,37,5,46,42
air_683371d9baabf410,hpg_7dae95f9d3db1734,2017-01-12,37,13,46,50
air_683371d9baabf410,hpg_7dae95f9d3db1734,2017-01-13,14,4,32,18
air_683371d9baabf410,hpg_7dae95f9d3db1734,2017-01-14,21,5,36,26
air_683371d9baabf410,hpg_7dae95f9d3db1734,2017-01-15,24,5,33,29
air_683371d9baabf410,hpg_7dae95f9d3db1734,2017-01-19,32,10,44,42
air_683371d9baabf410,hpg_7dae95f9d3db1734,2017-01-20,40,5,50,45
air_683371d9baabf410,hpg_7dae95f9d3db1734,2017-01-21,33,11,43,44
air_683371d9baabf410,hpg_7dae95f9d3db1734,2017-01-22,2,2,12,4
air_683371d9baabf410,hpg_7dae95f9d3db1734,2017-01-24,12,4,36,16
air_683371d9baabf410,hpg_7dae95f9d3db1734,2017-01-25,15,9,33,24
air_683371d9baabf410,hpg_7dae95f9d3db1734,2017-01-26,10,3,25,13
air_683371d9baabf410,hpg_7dae95f9d3db1734,2017-01-28,17,17,38,34
air_683371d9baabf410,hpg_7dae95f9d3db1734,2017-01-29,39,6,41,45
air_683371d9baabf410,hpg_7dae95f9d3db1734,2017-02-02,3,6,9,9
air_683371d9baabf410,hpg_7dae95f9d3db1734,2017-02-03,19,5,65,24
air_683371d9baabf410,hpg_7dae95f9d3db1734,2017-02-04,22,7,32,29
air_683371d9baabf410,hpg_7dae95f9d3db1734,2017-02-05,34,20,40,54
air_683371d9baabf410,hpg_7dae95f9d3db1734,2017-02-07,26,13,39,39
air_683371d9baabf410,hpg_7dae95f9d3db1734,2017-02-08,3,3,26,6
air_683371d9baabf410,hpg_7dae95f9d3db1734,2017-02-09,15,13,29,28
air_683371d9baabf410,hpg_7dae95f9d3db1734,2017-02-10,41,12,47,53
air_683371d9baabf410,hpg_7dae95f9d3db1734,2017-02-11,30,8,42,38
air_683371d9baabf410,hpg_7dae95f9d3db1734,2017-02-12,19,8,24,27
air_683371d9baabf410,hpg_7dae95f9d3db1734,2017-02-15,23,4,46,27
air_683371d9baabf410,hpg_7dae95f9d3db1734,2017-02-16,20,4,35,24
air_683371d9baabf410,hpg_7dae95f9d3db1734,2017-02-17,16,6,34,22
air_683371d9baabf410,hpg_7dae95f9d3db1734,2017-02-18,14,2,39,16
air_683371d9baabf410,hpg_7dae95f9d3db1734,2017-02-19,41,14,48,55
air_683371d9baabf410,hpg_7dae95f9d3db1734,2017-02-21,17,11,29,28
air_683371d9baabf410,hpg_7dae95f9d3db1734,2017-02-22,6,4,28,10
air_683371d9baabf410,hpg_7dae95f9d3db1734,2017-02-25,40,8,52,48
air_683371d9baabf410,hpg_7dae95f9d3db1734,2017-02-26,38,13,49,51
air_683371d9baabf410,hpg_7dae95f9d3db1734,2017-02-28,35,7,50,42
air_683371d9baabf410,hpg_7dae95f9d3db1734,2017-03-01,30,31,52,61
air_683371d9baabf410,hpg_7dae95f9d3db1734,2017-03-02,2,2,28,4
air_683371d9baabf410,hpg_7dae95f9d3db1734,2017-03-04,38,8,40,46
air_683371d9baabf410,hpg_7dae95f9d3db1734,2017-03-05,33,3,41,36
air_683371d9baabf410,hpg_7dae95f9d3db1734,2017-03-08,12,12,22,24
air_683371d9baabf410,hpg_7dae95f9d3db1734,2017-03-10,30,3,39,33
air_683371d9baabf410,hpg_7dae95f9d3db1734,2017-03-11,14,2,32,16
air_683371d9baabf410,hpg_7dae95f9d3db1734,2017-03-12,24,28,27,52
air_683371d9baabf410,hpg_7dae95f9d3db1734,2017-03-14,21,6,40,27
air_683371d9baabf410,hpg_7dae95f9d3db1734,2017-03-15,17,9,24,26
air_683371d9baabf410,hpg_7dae95f9d3db1734,2017-03-16,20,2,31,22
air_683371d9baabf410,hpg_7dae95f9d3db1734,2017-03-17,61,16,59,77
air_683371d9baabf410,hpg_7dae95f9d3db1734,2017-03-18,24,4,30,28
air_683371d9baabf410,hpg_7dae95f9d3db1734,2017-03-20,23,27,23,50
air_683371d9baabf410,hpg_7dae95f9d3db1734,2017-03-21,43,21,49,64
air_683371d9baabf410,hpg_7dae95f9d3db1734,2017-03-22,12,3,31,15
air_683371d9baabf410,hpg_7dae95f9d3db1734,2017-03-23,2,2,24,4
air_683371d9baabf410,hpg_7dae95f9d3db1734,2017-03-24,36,3,55,39
air_683371d9baabf410,hpg_7dae95f9d3db1734,2017-03-25,43,18,54,61
air_683371d9baabf410,hpg_7dae95f9d3db1734,2017-03-26,19,10,26,29
air_683371d9baabf410,hpg_7dae95f9d3db1734,2017-03-28,12,7,40,19
air_683371d9baabf410,hpg_7dae95f9d3db1734,2017-03-29,34,10,52,44
air_683371d9baabf410,hpg_7dae95f9d3db1734,2017-03-30,21,6,33,27
air_683371d9baabf410,hpg_7dae95f9d3db1734,2017-03-31,7,5,38,12
air_683371d9baabf410,hpg_7dae95f9d3db1734,2017-04-01,43,16,43,59
air_683371d9baabf410,hpg_7dae95f9d3db1734,2017-04-02,20,6,20,26
air_683371d9baabf410,hpg_7dae95f9d3db1734,2017-04-04,20,4,34,24
air_683371d9baabf410,hpg_7dae95f9d3db1734,2017-04-05,35,3,38,38
air_683371d9baabf410,hpg_7dae95f9d3db1734,2017-04-06,25,2,31,27
air_683371d9baabf410,hpg_7dae95f9d3db1734,2017-04-07,3,27,5,30
air_683371d9baabf410,hpg_7dae95f9d3db1734,2017-04-08,23,18,28,41
air_683371d9baabf410,hpg_7dae95f9d3db1734,2017-04-09,28,2,52,30
air_683371d9baabf410,hpg_7dae95f9d3db1734,2017-04-11,31,2,31,33
air_683371d9baabf410,hpg_7dae95f9d3db1734,2017-04-14,24,2,42,26
air_683371d9baabf410,hpg_7dae95f9d3db1734,2017-04-16,17,8,25,25
air_683371d9baabf410,hpg_7dae95f9d3db1734,2017-04-19,39,12,55,51
air_683371d9baabf410,hpg_7dae95f9d3db1734,2017-04-20,33,7,41,40
air_683371d9baabf410,hpg_7dae95f9d3db1734,2017-04-21,16,3,25,19
air_683371d9baabf410,hpg_7dae95f9d3db1734,2017-04-22,21,5,30,26
air_bb09595bab7d5cfb,hpg_aea428a1075052bf,2016-10-27,7,2,15,9
air_bb09595bab7d5cfb,hpg_aea428a1075052bf,2016-10-30,16,10,34,26
air_bb09595bab7d5cfb,hpg_aea428a1075052bf,2016-11-02,14,12,23,26
air_bb09595bab7d5cfb,hpg_aea428a1075052bf,2016-11-04,15,7,25,22
air_bb09595bab7d5cfb,hpg_aea428a1075052bf,2016-11-05,17,11,52,28
air_bb09595bab7d5cfb,hpg_aea428a1075052bf,2016-11-13,10,3,37,13
air_bb09595bab7d5cfb,hpg_aea428a1075052bf,2016-11-17,4,4,14,8
air_bb09595bab7d5cfb,hpg_aea428a1075052bf,2016-11-18,10,10,30,20
air_bb09595bab7d5cfb,hpg_aea428a1075052bf,2016-11-21,14,7,25,21
air_bb09595bab7d5cfb,hpg_aea428a1075052bf,2016-11-24,9,6,6,15
air_bb09595bab7d5cfb,hpg_aea428a1075052bf,2016-11-25,14,7,39,21
air_bb09595bab7d5cfb,hpg_aea428a1075052bf,2016-12-02,14,5,33,19
air_bb09595bab7d5cfb,hpg_aea428a1075052bf,2016-12-09,13,3,14,16
air_bb09595bab7d5cfb,hpg_aea428a1075052bf,2016-12-10,20,14,64,34
air_bb09595bab7d5cfb,hpg_aea428a1075052bf,2016-12-11,12,9,35,21
air_bb09595bab7d5cfb,hpg_aea428a1075052bf,2016-12-12,7,7,23,14
air_bb09595bab7d5cfb,hpg_aea428a1075052bf,2016-12-15,5,5,8,10
air_bb09595bab7d5cfb,hpg_aea428a1075052bf,2016-12-17,44,7,48,51
air_bb09595bab7d5cfb,hpg_aea428a1075052bf,2016-12-19,17,5,16,22
air_bb09595bab7d5cfb,hpg_aea428a1075052bf,2016-12-21,24,15,33,39
air_bb09595bab7d5cfb,hpg_aea428a1075052bf,2016-12-22,33,7,42,40
air_bb09595bab7d5cfb,hpg_aea428a1075052bf,2016-12-23,22,10,66,32
air_bb09595bab7d5cfb,hpg_aea428a1075052bf,2016-12-24,6,18,22,24
air_bb09595bab7d5cfb,hpg_aea428a1075052bf,2016-12-26,19,2,30,21
air_bb09595bab7d5cfb,hpg_aea428a1075052bf,2016-12-28,22,4,26,26
air_bb09595bab7d5cfb,hpg_aea428a1075052bf,2016-12-30,10,5,45,15
air_bb09595bab7d5cfb,hpg_aea428a1075052bf,2017-01-04,7,5,30,12
air_bb09595bab7d5cfb,hpg_aea428a1075052bf,2017-01-06,24,25,28,49
air_bb09595bab7d5cfb,hpg_aea428a1075052bf,2017-01-08,9,4,35,13
air_bb09595bab7d5cfb,hpg_aea428a1075052bf,2017-01-11,4,6,10,10
air_bb09595bab7d5cfb,hpg_aea428a1075052bf,2017-01-12,17,6,4,23
air_bb09595bab7d5cfb,hpg_aea428a1075052bf,2017-01-16,13,13,29,26
air_bb09595bab7d5cfb,hpg_aea428a1075052bf,2017-01-20,15,15,34,30
air_bb09595bab7d5cfb,hpg_aea428a1075052bf,2017-01-21,6,5,29,11
air_bb09595bab7d5cfb,hpg_aea428a1075052bf,2017-01-22,19,7,39,26
air_bb09595bab7d5cfb,hpg_aea428a1075052bf,2017-01-23,9,10,30,19
air_bb09595bab7d5cfb,hpg_aea428a1075052bf,2017-01-28,13,10,45,23
air_bb09595bab7d5cfb,hpg_aea428a1075052bf,2017-01-29,16,5,27,21
air_bb09595bab7d5cfb,hpg_aea428a1075052bf,2017-02-01,9,7,17,16
air_bb09595bab7d5cfb,hpg_aea428a1075052bf,2017-02-02,8,2,20,10
air_bb09595bab7d5cfb,hpg_aea428a1075052bf,2017-02-03,8,8,27,16
air_bb09595bab7d5cfb,hpg_aea428a1075052bf,2017-02-04,12,9,37,21
air_bb09595bab7d5cfb,hpg_aea428a1075052bf,2017-02-09,2,2,22,4
air_bb09595bab7d5cfb,hpg_aea428a1075052bf,2017-02-10,12,4,26,16
air_bb09595bab7d5cfb,hpg_aea428a1075052bf,2017-02-11,11,7,50,18
air_bb09595bab7d5cfb,hpg_aea428a1075052bf,2017-02-15,8,2,25,10
air_bb09595bab7d5cfb,hpg_aea428a1075052bf,2017-02-16,12,9,37,21
air_bb09595bab7d5cfb,hpg_aea428a1075052bf,2017-02-17,30,10,49,40
air_bb09595bab7d5cfb,hpg_aea428a1075052bf,2017-02-18,19,5,33,24
air_bb09595bab7d5cfb,hpg_aea428a1075052bf,2017-02-19,19,13,54,32
air_bb09595bab7d5cfb,hpg_aea428a1075052bf,2017-02-20,10,2,39,12
air_bb09595bab7d5cfb,hpg_aea428a1075052bf,2017-02-22,6,6,5,12
air_bb09595bab7d5cfb,hpg_aea428a1075052bf,2017-02-23,12,5,41,17
air_bb09595bab7d5cfb,hpg_aea428a1075052bf,2017-02-24,18,16,23,34
air_bb09595bab7d5cfb,hpg_aea428a1075052bf,2017-02-25,15,6,42,21
air_bb09595bab7d5cfb,hpg_aea428a1075052bf,2017-03-01,11,10,9,21
air_bb09595bab7d5cfb,hpg_aea428a1075052bf,2017-03-03,13,6,19,19
air_bb09595bab7d5cfb,hpg_aea428a1075052bf,2017-03-09,24,5,43,29
air_bb09595bab7d5cfb,hpg_aea428a1075052bf,2017-03-10,7,6,28,13
air_bb09595bab7d5cfb,hpg_aea428a1075052bf,2017-03-11,7,2,44,9
air_bb09595bab7d5cfb,hpg_aea428a1075052bf,2017-03-13,6,13,16,19
air_bb09595bab7d5cfb,hpg_aea428a1075052bf,2017-03-17,12,8,19,20
air_bb09595bab7d5cfb,hpg_aea428a1075052bf,2017-03-19,14,6,43,20
air_bb09595bab7d5cfb,hpg_aea428a1075052bf,2017-03-20,10,2,47,12
air_bb09595bab7d5cfb,hpg_aea428a1075052bf,2017-03-23,24,11,19,35
air_bb09595bab7d5cfb,hpg_aea428a1075052bf,2017-03-24,13,6,67,19
air_bb09595bab7d5cfb,hpg_aea428a1075052bf,2017-03-25,20,3,32,23
air_bb09595bab7d5cfb,hpg_aea428a1075052bf,2017-03-27,14,11,16,25
air_bb09595bab7d5cfb,hpg_aea428a1075052bf,2017-03-30,10,2,21,12
air_bb09595bab7d5cfb,hpg_aea428a1075052bf,2017-03-31,3,3,33,6
air_bb09595bab7d5cfb,hpg_aea428a1075052bf,2017-04-01,9,3,41,12
air_bb09595bab7d5cfb,hpg_aea428a1075052bf,2017-04-06,2,2,22,4
air_bb09595bab7d5cfb,hpg_aea428a1075052bf,2017-04-07,11,5,19,16
air_bb09595bab7d5cfb,hpg_aea428a1075052bf,2017-04-08,3,3,36,6
air_bb09595bab7d5cfb,hpg_aea428a1075052bf,2017-04-10,12,2,15,14
air_bb09595bab7d5cfb,hpg_aea428a1075052bf,2017-04-14,23,2,52,25
air_bb09595bab7d5cfb,hpg_aea428a1075052bf,2017-04-16,5,3,27,8
air_bb09595bab7d5cfb,hpg_aea428a1075052bf,2017-04-22,25,9,47,34
air_3c938075889fc059,hpg_349b1b92f98b175e,2016-10-31,18,10,72,28
air_3c938075889fc059,hpg_349b1b92f98b175e,2016-11-07,2,2,23,4
air_3c938075889fc059,hpg_349b1b92f98b175e,2016-11-12,14,2,19,16
air_3c938075889fc059,hpg_349b1b92f98b175e,2016-11-14,15,2,57,17
air_3c938075889fc059,hpg_349b1b92f98b175e,2016-11-17,22,22,35,44
air_3c938075889fc059,hpg_349b1b92f98b175e,2016-11-19,15,13,23,28
air_3c938075889fc059,hpg_349b1b92f98b175e,2016-11-20,9,2,21,11
air_3c938075889fc059,hpg_349b1b92f98b175e,2016-11-26,51,12,55,63
air_3c938075889fc059,hpg_349b1b92f98b175e,2016-11-28,11,15,27,26
air_3c938075889fc059,hpg_349b1b92f98b175e,2016-12-01,5,5,13,10
air_3c938075889fc059,hpg_349b1b92f98b175e,2016-12-02,5,5,41,10
air_3c938075889fc059,hpg_349b1b92f98b175e,2016-12-05,21,21,29,42
air_3c938075889fc059,hpg_349b1b92f98b175e,2016-12-09,39,43,59,82
air_3c938075889fc059,hpg_349b1b92f98b175e,2016-12-11,7,2,30,9
air_3c938075889fc059,hpg_349b1b92f98b175e,2016-12-15,26,10,34,36
air_3c938075889fc059,hpg_349b1b92f98b175e,2016-12-16,26,38,61,64
air_3c938075889fc059,hpg_349b1b92f98b175e,2016-12-18,10,4,47,14
air_3c938075889fc059,hpg_349b1b92f98b175e,2016-12-19,44,16,46,60
air_3c938075889fc059,hpg_349b1b92f98b175e,2016-12-21,53,53,54,106
air_3c938075889fc059,hpg_349b1b92f98b175e,2016-12-22,59,42,65,101
air_3c938075889fc059,hpg_349b1b92f98b175e,2016-12-26,11,6,25,17
air_3c938075889fc059,hpg_349b1b92f98b175e,2016-12-28,41,25,108,66
air_3c938075889fc059,hpg_349b1b92f98b175e,2016-12-29,23,26,44,49
air_3c938075889fc059,hpg_349b1b92f98b175e,2016-12-30,21,7,38,28
air_3c938075889fc059,hpg_349b1b92f98b175e,2017-01-05,16,11,21,27
air_3c938075889fc059,hpg_349b1b92f98b175e,2017-01-08,12,6,29,18
air_3c938075889fc059,hpg_349b1b92f98b175e,2017-01-09,4,2,9,6
air_3c938075889fc059,hpg_349b1b92f98b175e,2017-01-13,39,65,52,104
air_3c938075889fc059,hpg_349b1b92f98b175e,2017-01-20,37,18,53,55
air_3c938075889fc059,hpg_349b1b92f98b175e,2017-01-21,66,2,91,68
air_3c938075889fc059,hpg_349b1b92f98b175e,2017-01-22,10,9,14,19
air_3c938075889fc059,hpg_349b1b92f98b175e,2017-01-26,30,34,31,64
air_3c938075889fc059,hpg_349b1b92f98b175e,2017-01-27,43,14,48,57
air_3c938075889fc059,hpg_349b1b92f98b175e,2017-01-28,23,12,30,35
air_3c938075889fc059,hpg_349b1b92f98b175e,2017-02-09,18,18,20,36
air_3c938075889fc059,hpg_349b1b92f98b175e,2017-02-15,23,28,28,51
air_3c938075889fc059,hpg_349b1b92f98b175e,2017-02-23,7,8,20,15
air_3c938075889fc059,hpg_349b1b92f98b175e,2017-02-24,27,6,67,33
air_3c938075889fc059,hpg_349b1b92f98b175e,2017-02-26,8,6,16,14
air_3c938075889fc059,hpg_349b1b92f98b175e,2017-03-03,78,6,83,84
air_3c938075889fc059,hpg_349b1b92f98b175e,2017-03-06,5,5,9,10
air_3c938075889fc059,hpg_349b1b92f98b175e,2017-03-08,25,3,25,28
air_3c938075889fc059,hpg_349b1b92f98b175e,2017-03-11,7,4,15,11
air_3c938075889fc059,hpg_349b1b92f98b175e,2017-03-13,11,8,15,19
air_3c938075889fc059,hpg_349b1b92f98b175e,2017-03-18,13,2,37,15
air_3c938075889fc059,hpg_349b1b92f98b175e,2017-03-22,15,16,26,31
air_3c938075889fc059,hpg_349b1b92f98b175e,2017-03-24,66,10,80,76
air_3c938075889fc059,hpg_349b1b92f98b175e,2017-03-27,33,3,38,36
air_3c938075889fc059,hpg_349b1b92f98b175e,2017-03-29,41,28,49,69
air_3c938075889fc059,hpg_349b1b92f98b175e,2017-03-31,39,4,77,43
air_3c938075889fc059,hpg_349b1b92f98b175e,2017-04-01,7,7,25,14
air_3c938075889fc059,hpg_349b1b92f98b175e,2017-04-07,10,33,62,43
air_3c938075889fc059,hpg_349b1b92f98b175e,2017-04-14,16,4,60,20
air_3c938075889fc059,hpg_349b1b92f98b175e,2017-04-15,31,6,44,37
air_3c938075889fc059,hpg_349b1b92f98b175e,2017-04-21,48,17,63,65
air_96005f79124e12bf,hpg_51fab1683266cd55,2016-12-09,2,9,14,11
air_a38f25e3399d1b25,hpg_50378da9ffb9b6cd,2016-11-18,15,7,41,22
air_a38f25e3399d1b25,hpg_50378da9ffb9b6cd,2016-11-26,17,4,43,21
air_a38f25e3399d1b25,hpg_50378da9ffb9b6cd,2016-12-15,63,35,105,98
air_a38f25e3399d1b25,hpg_50378da9ffb9b6cd,2016-12-28,70,35,97,105
air_a38f25e3399d1b25,hpg_50378da9ffb9b6cd,2017-01-12,51,22,63,73
air_a38f25e3399d1b25,hpg_50378da9ffb9b6cd,2017-01-25,3,9,41,12
air_a38f25e3399d1b25,hpg_50378da9ffb9b6cd,2017-02-10,37,11,47,48
air_a38f25e3399d1b25,hpg_50378da9ffb9b6cd,2017-02-18,32,5,30,37
air_a38f25e3399d1b25,hpg_50378da9ffb9b6cd,2017-02-23,47,10,57,57
air_a38f25e3399d1b25,hpg_50378da9ffb9b6cd,2017-02-27,41,27,46,68
air_a38f25e3399d1b25,hpg_50378da9ffb9b6cd,2017-03-24,46,2,67,48
air_a38f25e3399d1b25,hpg_50378da9ffb9b6cd,2017-04-19,39,17,58,56
air_a38f25e3399d1b25,hpg_50378da9ffb9b6cd,2017-04-21,52,23,77,75
air_48f4da6223571da4,hpg_832ba309e6699258,2016-07-02,15,13,37,28
air_48f4da6223571da4,hpg_832ba309e6699258,2016-07-03,2,2,22,4
air_48f4da6223571da4,hpg_832ba309e6699258,2016-07-05,4,4,12,8
air_48f4da6223571da4,hpg_832ba309e6699258,2016-07-08,18,20,33,38
air_48f4da6223571da4,hpg_832ba309e6699258,2016-07-09,6,6,21,12
air_48f4da6223571da4,hpg_832ba309e6699258,2016-07-10,4,4,28,8
air_48f4da6223571da4,hpg_832ba309e6699258,2016-07-13,4,4,13,8
air_48f4da6223571da4,hpg_832ba309e6699258,2016-07-14,2,2,32,4
air_48f4da6223571da4,hpg_832ba309e6699258,2016-07-16,4,4,47,8
air_48f4da6223571da4,hpg_832ba309e6699258,2016-10-27,2,2,16,4
air_48f4da6223571da4,hpg_832ba309e6699258,2016-10-29,19,40,30,59
air_48f4da6223571da4,hpg_832ba309e6699258,2016-11-02,11,11,22,22
air_48f4da6223571da4,hpg_832ba309e6699258,2016-11-03,9,9,51,18
air_48f4da6223571da4,hpg_832ba309e6699258,2016-11-05,2,2,33,4
air_48f4da6223571da4,hpg_832ba309e6699258,2016-11-09,2,2,11,4
air_48f4da6223571da4,hpg_832ba309e6699258,2016-11-10,5,5,18,10
air_48f4da6223571da4,hpg_832ba309e6699258,2016-11-11,7,6,33,13
air_48f4da6223571da4,hpg_832ba309e6699258,2016-11-13,8,3,21,11
air_48f4da6223571da4,hpg_832ba309e6699258,2016-11-14,2,2,15,4
air_48f4da6223571da4,hpg_832ba309e6699258,2016-11-15,9,5,14,14
air_48f4da6223571da4,hpg_832ba309e6699258,2016-11-19,10,9,32,19
air_48f4da6223571da4,hpg_832ba309e6699258,2016-11-21,2,2,19,4
air_48f4da6223571da4,hpg_832ba309e6699258,2016-11-23,7,9,33,16
air_48f4da6223571da4,hpg_832ba309e6699258,2016-11-25,16,21,18,37
air_48f4da6223571da4,hpg_832ba309e6699258,2016-11-26,20,24,33,44
air_48f4da6223571da4,hpg_832ba309e6699258,2016-11-27,2,2,19,4
air_48f4da6223571da4,hpg_832ba309e6699258,2016-11-28,4,5,26,9
air_48f4da6223571da4,hpg_832ba309e6699258,2016-11-29,2,2,13,4
air_48f4da6223571da4,hpg_832ba309e6699258,2016-11-30,5,5,19,10
air_48f4da6223571da4,hpg_832ba309e6699258,2016-12-02,7,7,14,14
air_48f4da6223571da4,hpg_832ba309e6699258,2016-12-03,8,13,28,21
air_48f4da6223571da4,hpg_832ba309e6699258,2016-12-04,4,4,30,8
air_48f4da6223571da4,hpg_832ba309e6699258,2016-12-07,8,5,16,13
air_48f4da6223571da4,hpg_832ba309e6699258,2016-12-10,11,20,29,31
air_48f4da6223571da4,hpg_832ba309e6699258,2016-12-12,5,7,20,12
air_48f4da6223571da4,hpg_832ba309e6699258,2016-12-17,12,14,43,26
air_48f4da6223571da4,hpg_832ba309e6699258,2016-12-19,2,2,24,4
air_48f4da6223571da4,hpg_832ba309e6699258,2016-12-20,4,4,20,8
air_48f4da6223571da4,hpg_832ba309e6699258,2016-12-21,3,16,12,19
air_48f4da6223571da4,hpg_832ba309e6699258,2016-12-23,10,10,39,20
air_48f4da6223571da4,hpg_832ba309e6699258,2016-12-24,4,4,56,8
air_48f4da6223571da4,hpg_832ba309e6699258,2016-12-25,21,2,41,23
air_48f4da6223571da4,hpg_832ba309e6699258,2016-12-26,23,23,40,46
air_48f4da6223571da4,hpg_832ba309e6699258,2016-12-29,5,5,31,10
air_48f4da6223571da4,hpg_832ba309e6699258,2016-12-30,4,4,27,8
air_48f4da6223571da4,hpg_832ba309e6699258,2017-01-05,5,5,14,10
air_48f4da6223571da4,hpg_832ba309e6699258,2017-01-08,8,3,23,11
air_48f4da6223571da4,hpg_832ba309e6699258,2017-01-14,22,22,38,44
air_48f4da6223571da4,hpg_832ba309e6699258,2017-01-15,6,11,27,17
air_48f4da6223571da4,hpg_832ba309e6699258,2017-01-17,2,2,17,4
air_48f4da6223571da4,hpg_832ba309e6699258,2017-01-20,4,4,20,8
air_48f4da6223571da4,hpg_832ba309e6699258,2017-01-21,10,10,38,20
air_48f4da6223571da4,hpg_832ba309e6699258,2017-01-23,2,2,17,4
air_48f4da6223571da4,hpg_832ba309e6699258,2017-01-25,2,2,9,4
air_48f4da6223571da4,hpg_832ba309e6699258,2017-01-26,2,2,22,4
air_48f4da6223571da4,hpg_832ba309e6699258,2017-01-27,14,14,20,28
air_48f4da6223571da4,hpg_832ba309e6699258,2017-01-31,5,5,25,10
air_48f4da6223571da4,hpg_832ba309e6699258,2017-02-02,2,2,11,4
air_48f4da6223571da4,hpg_832ba309e6699258,2017-02-04,2,2,23,4
air_48f4da6223571da4,hpg_832ba309e6699258,2017-02-06,8,8,19,16
air_48f4da6223571da4,hpg_832ba309e6699258,2017-02-08,8,8,11,16
air_48f4da6223571da4,hpg_832ba309e6699258,2017-02-11,3,3,29,6
air_48f4da6223571da4,hpg_832ba309e6699258,2017-02-12,9,11,38,20
air_48f4da6223571da4,hpg_832ba309e6699258,2017-02-14,2,2,10,4
air_48f4da6223571da4,hpg_832ba309e6699258,2017-02-15,7,5,14,12
air_48f4da6223571da4,hpg_832ba309e6699258,2017-02-16,11,13,13,24
air_48f4da6223571da4,hpg_832ba309e6699258,2017-02-17,4,2,17,6
air_48f4da6223571da4,hpg_832ba309e6699258,2017-02-18,4,2,16,6
air_48f4da6223571da4,hpg_832ba309e6699258,2017-02-20,2,5,19,7
air_48f4da6223571da4,hpg_832ba309e6699258,2017-02-23,7,4,15,11
air_48f4da6223571da4,hpg_832ba309e6699258,2017-02-26,4,4,22,8
air_48f4da6223571da4,hpg_832ba309e6699258,2017-02-27,15,11,23,26
air_48f4da6223571da4,hpg_832ba309e6699258,2017-02-28,4,4,4,8
air_48f4da6223571da4,hpg_832ba309e6699258,2017-03-01,3,3,3,6
air_48f4da6223571da4,hpg_832ba309e6699258,2017-03-02,5,5,15,10
air_48f4da6223571da4,hpg_832ba309e6699258,2017-03-06,10,5,20,15
air_48f4da6223571da4,hpg_832ba309e6699258,2017-03-07,2,2,15,4
air_48f4da6223571da4,hpg_832ba309e6699258,2017-03-08,2,2,2,4
air_48f4da6223571da4,hpg_832ba309e6699258,2017-03-10,12,14,19,26
air_48f4da6223571da4,hpg_832ba309e6699258,2017-03-11,4,16,28,20
air_48f4da6223571da4,hpg_832ba309e6699258,2017-03-12,13,15,36,28
air_48f4da6223571da4,hpg_832ba309e6699258,2017-03-15,6,4,9,10
air_48f4da6223571da4,hpg_832ba309e6699258,2017-03-16,10,3,22,13
air_48f4da6223571da4,hpg_832ba309e6699258,2017-03-18,5,3,38,8
air_48f4da6223571da4,hpg_832ba309e6699258,2017-03-20,13,13,24,26
air_48f4da6223571da4,hpg_832ba309e6699258,2017-03-22,2,2,16,4
air_48f4da6223571da4,hpg_832ba309e6699258,2017-03-23,4,4,14,8
air_48f4da6223571da4,hpg_832ba309e6699258,2017-03-24,13,13,43,26
air_48f4da6223571da4,hpg_832ba309e6699258,2017-03-25,7,5,46,12
air_48f4da6223571da4,hpg_832ba309e6699258,2017-03-26,12,10,34,22
air_48f4da6223571da4,hpg_832ba309e6699258,2017-03-27,7,4,19,11
air_48f4da6223571da4,hpg_832ba309e6699258,2017-03-31,20,65,23,85
air_48f4da6223571da4,hpg_832ba309e6699258,2017-04-02,4,4,30,8
air_48f4da6223571da4,hpg_832ba309e6699258,2017-04-03,5,5,11,10
air_48f4da6223571da4,hpg_832ba309e6699258,2017-04-06,5,5,15,10
air_48f4da6223571da4,hpg_832ba309e6699258,2017-04-07,2,2,10,4
air_48f4da6223571da4,hpg_832ba309e6699258,2017-04-08,2,2,36,4
air_48f4da6223571da4,hpg_832ba309e6699258,2017-04-11,2,2,7,4
air_48f4da6223571da4,hpg_832ba309e6699258,2017-04-14,9,9,19,18
air_48f4da6223571da4,hpg_832ba309e6699258,2017-04-15,19,19,38,38
air_48f4da6223571da4,hpg_832ba309e6699258,2017-04-16,8,6,38,14
air_48f4da6223571da4,hpg_832ba309e6699258,2017-04-17,2,2,14,4
air_48f4da6223571da4,hpg_832ba309e6699258,2017-04-19,9,8,17,17
air_48f4da6223571da4,hpg_832ba309e6699258,2017-04-21,7,15,25,22
air_48f4da6223571da4,hpg_832ba309e6699258,2017-04-22,19,14,34,33
air_c3585b0fba3998d0,hpg_0db6a8b36006942a,2016-12-16,16,4,20,20
air_c3585b0fba3998d0,hpg_0db6a8b36006942a,2017-01-08,2,13,2,15
air_c3585b0fba3998d0,hpg_0db6a8b36006942a,2017-02-04,7,7,7,14
air_c3585b0fba3998d0,hpg_0db6a8b36006942a,2017-02-25,31,2,35,33
air_c3585b0fba3998d0,hpg_0db6a8b36006942a,2017-03-31,6,6,19,12
air_c3585b0fba3998d0,hpg_0db6a8b36006942a,2017-04-14,2,2,3,4
air_f2c5a1f24279c531,hpg_9668001cf2b8dc74,2016-11-25,25,6,39,31
air_f2c5a1f24279c531,hpg_9668001cf2b8dc74,2016-12-16,14,12,28,26
air_f2c5a1f24279c531,hpg_9668001cf2b8dc74,2016-12-17,6,3,21,9
air_f2c5a1f24279c531,hpg_9668001cf2b8dc74,2016-12-19,3,3,11,6
air_f2c5a1f24279c531,hpg_9668001cf2b8dc74,2016-12-22,9,9,34,18
air_f2c5a1f24279c531,hpg_9668001cf2b8dc74,2016-12-26,14,8,22,22
air_f2c5a1f24279c531,hpg_9668001cf2b8dc74,2016-12-31,2,2,22,4
air_f2c5a1f24279c531,hpg_9668001cf2b8dc74,2017-01-09,5,5,18,10
air_f2c5a1f24279c531,hpg_9668001cf2b8dc74,2017-01-10,3,3,22,6
air_f2c5a1f24279c531,hpg_9668001cf2b8dc74,2017-01-20,4,4,14,8
air_f2c5a1f24279c531,hpg_9668001cf2b8dc74,2017-01-28,3,5,9,8
air_f2c5a1f24279c531,hpg_9668001cf2b8dc74,2017-02-03,3,3,17,6
air_f2c5a1f24279c531,hpg_9668001cf2b8dc74,2017-02-10,3,3,24,6
air_fc477473134e9ae5,hpg_3c41f028563beac3,2016-10-29,23,10,41,33
air_fc477473134e9ae5,hpg_3c41f028563beac3,2016-11-02,19,2,33,21
air_fc477473134e9ae5,hpg_3c41f028563beac3,2016-11-04,6,2,21,8
air_fc477473134e9ae5,hpg_3c41f028563beac3,2016-11-12,2,2,40,4
air_fc477473134e9ae5,hpg_3c41f028563beac3,2016-11-15,20,25,30,45
air_fc477473134e9ae5,hpg_3c41f028563beac3,2016-11-24,18,6,11,24
air_fc477473134e9ae5,hpg_3c41f028563beac3,2016-11-25,4,2,20,6
air_fc477473134e9ae5,hpg_3c41f028563beac3,2016-11-26,32,22,60,54
air_fc477473134e9ae5,hpg_3c41f028563beac3,2016-11-30,2,2,12,4
air_fc477473134e9ae5,hpg_3c41f028563beac3,2016-12-02,35,7,43,42
air_fc477473134e9ae5,hpg_3c41f028563beac3,2016-12-03,53,54,18,107
air_fc477473134e9ae5,hpg_3c41f028563beac3,2016-12-09,30,5,17,35
air_fc477473134e9ae5,hpg_3c41f028563beac3,2016-12-10,17,2,57,19
air_fc477473134e9ae5,hpg_3c41f028563beac3,2016-12-12,2,2,7,4
air_fc477473134e9ae5,hpg_3c41f028563beac3,2016-12-13,10,6,24,16
air_fc477473134e9ae5,hpg_3c41f028563beac3,2016-12-14,9,2,32,11
air_fc477473134e9ae5,hpg_3c41f028563beac3,2016-12-17,29,13,45,42
air_fc477473134e9ae5,hpg_3c41f028563beac3,2016-12-18,7,7,17,14
air_fc477473134e9ae5,hpg_3c41f028563beac3,2016-12-19,21,5,35,26
air_fc477473134e9ae5,hpg_3c41f028563beac3,2016-12-21,6,2,10,8
air_fc477473134e9ae5,hpg_3c41f028563beac3,2016-12-22,16,4,25,20
air_fc477473134e9ae5,hpg_3c41f028563beac3,2016-12-23,12,4,26,16
air_fc477473134e9ae5,hpg_3c41f028563beac3,2016-12-24,5,2,28,7
air_fc477473134e9ae5,hpg_3c41f028563beac3,2016-12-26,12,2,22,14
air_fc477473134e9ae5,hpg_3c41f028563beac3,2016-12-28,48,13,54,61
air_fc477473134e9ae5,hpg_3c41f028563beac3,2016-12-29,8,2,58,10
air_fc477473134e9ae5,hpg_3c41f028563beac3,2016-12-30,30,14,58,44
air_fc477473134e9ae5,hpg_3c41f028563beac3,2017-01-04,6,2,17,8
air_fc477473134e9ae5,hpg_3c41f028563beac3,2017-01-06,8,2,1,10
air_fc477473134e9ae5,hpg_3c41f028563beac3,2017-01-13,24,12,45,36
air_fc477473134e9ae5,hpg_3c41f028563beac3,2017-01-20,9,2,15,11
air_fc477473134e9ae5,hpg_3c41f028563beac3,2017-01-27,12,2,34,14
air_fc477473134e9ae5,hpg_3c41f028563beac3,2017-02-02,8,6,16,14
air_fc477473134e9ae5,hpg_3c41f028563beac3,2017-02-03,27,22,32,49
air_fc477473134e9ae5,hpg_3c41f028563beac3,2017-02-04,7,5,28,12
air_fc477473134e9ae5,hpg_3c41f028563beac3,2017-02-10,2,6,14,8
air_fc477473134e9ae5,hpg_3c41f028563beac3,2017-02-13,29,3,5,32
air_fc477473134e9ae5,hpg_3c41f028563beac3,2017-02-17,31,17,35,48
air_fc477473134e9ae5,hpg_3c41f028563beac3,2017-02-18,26,2,39,28
air_fc477473134e9ae5,hpg_3c41f028563beac3,2017-02-20,5,5,11,10
air_fc477473134e9ae5,hpg_3c41f028563beac3,2017-02-25,27,10,45,37
air_fc477473134e9ae5,hpg_3c41f028563beac3,2017-02-27,3,3,4,6
air_fc477473134e9ae5,hpg_3c41f028563beac3,2017-03-04,24,16,17,40
air_fc477473134e9ae5,hpg_3c41f028563beac3,2017-03-05,15,19,38,34
air_fc477473134e9ae5,hpg_3c41f028563beac3,2017-03-11,9,9,43,18
air_fc477473134e9ae5,hpg_3c41f028563beac3,2017-03-15,11,13,22,24
air_fc477473134e9ae5,hpg_3c41f028563beac3,2017-03-16,13,11,13,24
air_fc477473134e9ae5,hpg_3c41f028563beac3,2017-03-20,4,4,36,8
air_fc477473134e9ae5,hpg_3c41f028563beac3,2017-03-21,4,4,6,8
air_fc477473134e9ae5,hpg_3c41f028563beac3,2017-03-24,10,2,20,12
air_fc477473134e9ae5,hpg_3c41f028563beac3,2017-03-27,21,6,23,27
air_fc477473134e9ae5,hpg_3c41f028563beac3,2017-03-31,25,4,28,29
air_fc477473134e9ae5,hpg_3c41f028563beac3,2017-04-01,10,3,36,13
air_fc477473134e9ae5,hpg_3c41f028563beac3,2017-04-15,3,3,32,6
air_fc477473134e9ae5,hpg_3c41f028563beac3,2017-04-16,7,2,21,9
air_fe22ef5a9cbef123,hpg_ee8cad9cd96718da,2016-01-09,12,8,39,20
air_fe22ef5a9cbef123,hpg_ee8cad9cd96718da,2016-01-22,14,3,25,17
air_fe22ef5a9cbef123,hpg_ee8cad9cd96718da,2016-01-23,3,13,42,16
air_fe22ef5a9cbef123,hpg_ee8cad9cd96718da,2016-01-24,4,4,21,8
air_fe22ef5a9cbef123,hpg_ee8cad9cd96718da,2016-01-30,23,3,22,26
air_fe22ef5a9cbef123,hpg_ee8cad9cd96718da,2016-02-01,2,2,16,4
air_fe22ef5a9cbef123,hpg_ee8cad9cd96718da,2016-02-07,2,2,22,4
air_fe22ef5a9cbef123,hpg_ee8cad9cd96718da,2016-02-08,16,14,18,30
air_fe22ef5a9cbef123,hpg_ee8cad9cd96718da,2016-02-14,2,2,16,4
air_fe22ef5a9cbef123,hpg_ee8cad9cd96718da,2016-02-20,14,18,38,32
air_fe22ef5a9cbef123,hpg_ee8cad9cd96718da,2016-02-25,8,8,27,16
air_fe22ef5a9cbef123,hpg_ee8cad9cd96718da,2016-02-26,23,25,32,48
air_fe22ef5a9cbef123,hpg_ee8cad9cd96718da,2016-02-27,4,7,35,11
air_fe22ef5a9cbef123,hpg_ee8cad9cd96718da,2016-02-29,23,4,26,27
air_fe22ef5a9cbef123,hpg_ee8cad9cd96718da,2016-03-01,7,4,30,11
air_fe22ef5a9cbef123,hpg_ee8cad9cd96718da,2016-03-02,2,2,18,4
air_fe22ef5a9cbef123,hpg_ee8cad9cd96718da,2016-03-04,14,2,22,16
air_fe22ef5a9cbef123,hpg_ee8cad9cd96718da,2016-03-05,8,2,42,10
air_fe22ef5a9cbef123,hpg_ee8cad9cd96718da,2016-03-08,3,7,12,10
air_fe22ef5a9cbef123,hpg_ee8cad9cd96718da,2016-03-11,22,20,33,42
air_fe22ef5a9cbef123,hpg_ee8cad9cd96718da,2016-03-17,3,3,14,6
air_fe22ef5a9cbef123,hpg_ee8cad9cd96718da,2016-03-18,30,4,37,34
air_fe22ef5a9cbef123,hpg_ee8cad9cd96718da,2016-03-24,2,2,13,4
air_fe22ef5a9cbef123,hpg_ee8cad9cd96718da,2016-03-25,18,18,53,36
air_fe22ef5a9cbef123,hpg_ee8cad9cd96718da,2016-03-26,24,24,58,48
air_fe22ef5a9cbef123,hpg_ee8cad9cd96718da,2016-03-29,19,3,45,22
air_fe22ef5a9cbef123,hpg_ee8cad9cd96718da,2016-04-02,8,6,28,14
air_fe22ef5a9cbef123,hpg_ee8cad9cd96718da,2016-04-05,5,5,73,10
air_fe22ef5a9cbef123,hpg_ee8cad9cd96718da,2016-04-06,11,14,17,25
air_fe22ef5a9cbef123,hpg_ee8cad9cd96718da,2016-04-09,2,2,16,4
air_fe22ef5a9cbef123,hpg_ee8cad9cd96718da,2016-04-10,9,3,42,12
air_fe22ef5a9cbef123,hpg_ee8cad9cd96718da,2016-04-14,2,14,21,16
air_fe22ef5a9cbef123,hpg_ee8cad9cd96718da,2016-04-22,24,7,27,31
air_fe22ef5a9cbef123,hpg_ee8cad9cd96718da,2016-04-23,10,7,59,17
air_fe22ef5a9cbef123,hpg_ee8cad9cd96718da,2016-04-30,10,10,59,20
air_fe22ef5a9cbef123,hpg_ee8cad9cd96718da,2016-05-01,8,8,31,16
air_fe22ef5a9cbef123,hpg_ee8cad9cd96718da,2016-05-03,3,7,46,10
air_fe22ef5a9cbef123,hpg_ee8cad9cd96718da,2016-05-06,2,5,17,7
air_fe22ef5a9cbef123,hpg_ee8cad9cd96718da,2016-05-12,4,2,10,6
air_fe22ef5a9cbef123,hpg_ee8cad9cd96718da,2016-05-17,2,2,7,4
air_fe22ef5a9cbef123,hpg_ee8cad9cd96718da,2016-05-27,10,2,14,12
air_fe22ef5a9cbef123,hpg_ee8cad9cd96718da,2016-06-04,17,27,63,44
air_fe22ef5a9cbef123,hpg_ee8cad9cd96718da,2016-06-11,10,18,38,28
air_fe22ef5a9cbef123,hpg_ee8cad9cd96718da,2016-06-16,6,6,11,12
air_fe22ef5a9cbef123,hpg_ee8cad9cd96718da,2016-06-17,2,2,22,4
air_fe22ef5a9cbef123,hpg_ee8cad9cd96718da,2016-06-18,11,6,34,17
air_fe22ef5a9cbef123,hpg_ee8cad9cd96718da,2016-06-25,9,17,63,26
air_fe22ef5a9cbef123,hpg_ee8cad9cd96718da,2016-07-02,5,5,33,10
air_fe22ef5a9cbef123,hpg_ee8cad9cd96718da,2016-07-08,13,20,26,33
air_fe22ef5a9cbef123,hpg_ee8cad9cd96718da,2016-07-23,6,9,32,15
air_fe22ef5a9cbef123,hpg_ee8cad9cd96718da,2016-11-07,4,4,35,8
air_fe22ef5a9cbef123,hpg_ee8cad9cd96718da,2016-11-12,8,2,41,10
air_fe22ef5a9cbef123,hpg_ee8cad9cd96718da,2016-11-19,15,17,54,32
air_fe22ef5a9cbef123,hpg_ee8cad9cd96718da,2016-11-22,2,2,21,4
air_fe22ef5a9cbef123,hpg_ee8cad9cd96718da,2016-11-25,2,2,26,4
air_fe22ef5a9cbef123,hpg_ee8cad9cd96718da,2016-12-02,5,5,25,10
air_fe22ef5a9cbef123,hpg_ee8cad9cd96718da,2016-12-03,4,6,58,10
air_fe22ef5a9cbef123,hpg_ee8cad9cd96718da,2016-12-04,24,24,51,48
air_fe22ef5a9cbef123,hpg_ee8cad9cd96718da,2016-12-09,33,35,45,68
air_fe22ef5a9cbef123,hpg_ee8cad9cd96718da,2016-12-10,29,5,67,34
air_fe22ef5a9cbef123,hpg_ee8cad9cd96718da,2016-12-16,5,5,35,10
air_fe22ef5a9cbef123,hpg_ee8cad9cd96718da,2016-12-17,43,4,75,47
air_fe22ef5a9cbef123,hpg_ee8cad9cd96718da,2016-12-19,2,2,42,4
air_fe22ef5a9cbef123,hpg_ee8cad9cd96718da,2016-12-22,21,21,30,42
air_fe22ef5a9cbef123,hpg_ee8cad9cd96718da,2016-12-23,20,20,70,40
air_fe22ef5a9cbef123,hpg_ee8cad9cd96718da,2016-12-24,14,12,51,26
air_fe22ef5a9cbef123,hpg_ee8cad9cd96718da,2016-12-30,16,6,46,22
air_fe22ef5a9cbef123,hpg_ee8cad9cd96718da,2017-01-06,9,10,15,19
air_fe22ef5a9cbef123,hpg_ee8cad9cd96718da,2017-01-15,13,13,44,26
air_fe22ef5a9cbef123,hpg_ee8cad9cd96718da,2017-01-16,32,34,41,66
air_fe22ef5a9cbef123,hpg_ee8cad9cd96718da,2017-01-21,6,2,47,8
air_fe22ef5a9cbef123,hpg_ee8cad9cd96718da,2017-01-23,6,2,35,8
air_fe22ef5a9cbef123,hpg_ee8cad9cd96718da,2017-01-28,13,4,58,17
air_fe22ef5a9cbef123,hpg_ee8cad9cd96718da,2017-01-29,28,2,69,30
air_fe22ef5a9cbef123,hpg_ee8cad9cd96718da,2017-02-18,2,2,37,4
air_fe22ef5a9cbef123,hpg_ee8cad9cd96718da,2017-02-24,2,2,14,4
air_fe22ef5a9cbef123,hpg_ee8cad9cd96718da,2017-02-25,2,2,43,4
air_fe22ef5a9cbef123,hpg_ee8cad9cd96718da,2017-03-03,4,2,30,6
air_fe22ef5a9cbef123,hpg_ee8cad9cd96718da,2017-03-04,8,5,43,13
air_fe22ef5a9cbef123,hpg_ee8cad9cd96718da,2017-03-11,6,4,63,10
air_fe22ef5a9cbef123,hpg_ee8cad9cd96718da,2017-03-18,5,5,44,10
air_fe22ef5a9cbef123,hpg_ee8cad9cd96718da,2017-03-19,38,32,44,70
air_fe22ef5a9cbef123,hpg_ee8cad9cd96718da,2017-03-27,9,7,47,16
air_fe22ef5a9cbef123,hpg_ee8cad9cd96718da,2017-03-31,2,2,27,4
air_fe22ef5a9cbef123,hpg_ee8cad9cd96718da,2017-04-15,3,3,21,6
air_fe22ef5a9cbef123,hpg_ee8cad9cd96718da,2017-04-21,3,3,26,6
air_fe22ef5a9cbef123,hpg_ee8cad9cd96718da,2017-04-22,8,4,22,12
air_0867f7bebad6a649,hpg_caf1082b9f445c7b,2016-10-28,2,2,10,4
air_0867f7bebad6a649,hpg_caf1082b9f445c7b,2016-11-02,2,30,11,32
air_0867f7bebad6a649,hpg_caf1082b9f445c7b,2016-11-05,40,4,71,44
air_0867f7bebad6a649,hpg_caf1082b9f445c7b,2016-11-06,3,3,15,6
air_0867f7bebad6a649,hpg_caf1082b9f445c7b,2016-11-13,20,4,27,24
air_0867f7bebad6a649,hpg_caf1082b9f445c7b,2016-11-17,8,6,31,14
air_0867f7bebad6a649,hpg_caf1082b9f445c7b,2016-11-26,44,4,57,48
air_0867f7bebad6a649,hpg_caf1082b9f445c7b,2016-12-08,5,2,14,7
air_0867f7bebad6a649,hpg_caf1082b9f445c7b,2016-12-10,13,4,56,17
air_0867f7bebad6a649,hpg_caf1082b9f445c7b,2016-12-13,2,2,9,4
air_0867f7bebad6a649,hpg_caf1082b9f445c7b,2016-12-14,12,12,19,24
air_0867f7bebad6a649,hpg_caf1082b9f445c7b,2016-12-16,50,19,48,69
air_0867f7bebad6a649,hpg_caf1082b9f445c7b,2016-12-17,33,16,81,49
air_0867f7bebad6a649,hpg_caf1082b9f445c7b,2016-12-19,15,5,19,20
air_0867f7bebad6a649,hpg_caf1082b9f445c7b,2016-12-22,9,30,46,39
air_0867f7bebad6a649,hpg_caf1082b9f445c7b,2016-12-23,27,11,59,38
air_0867f7bebad6a649,hpg_caf1082b9f445c7b,2016-12-24,16,20,20,36
air_0867f7bebad6a649,hpg_caf1082b9f445c7b,2016-12-25,7,2,18,9
air_0867f7bebad6a649,hpg_caf1082b9f445c7b,2016-12-28,2,2,26,4
air_0867f7bebad6a649,hpg_caf1082b9f445c7b,2016-12-31,4,2,31,6
air_0867f7bebad6a649,hpg_caf1082b9f445c7b,2017-01-02,5,3,62,8
air_0867f7bebad6a649,hpg_caf1082b9f445c7b,2017-01-03,14,8,32,22
air_0867f7bebad6a649,hpg_caf1082b9f445c7b,2017-01-06,2,2,16,4
air_0867f7bebad6a649,hpg_caf1082b9f445c7b,2017-01-07,18,2,24,20
air_0867f7bebad6a649,hpg_caf1082b9f445c7b,2017-01-10,8,3,20,11
air_0867f7bebad6a649,hpg_caf1082b9f445c7b,2017-01-13,3,3,14,6
air_0867f7bebad6a649,hpg_caf1082b9f445c7b,2017-01-14,6,5,17,11
air_0867f7bebad6a649,hpg_caf1082b9f445c7b,2017-01-20,4,2,10,6
air_0867f7bebad6a649,hpg_caf1082b9f445c7b,2017-01-21,17,9,40,26
air_0867f7bebad6a649,hpg_caf1082b9f445c7b,2017-02-04,8,2,28,10
air_0867f7bebad6a649,hpg_caf1082b9f445c7b,2017-02-08,2,2,6,4
air_0867f7bebad6a649,hpg_caf1082b9f445c7b,2017-02-12,11,2,30,13
air_0867f7bebad6a649,hpg_caf1082b9f445c7b,2017-02-23,6,6,11,12
air_0867f7bebad6a649,hpg_caf1082b9f445c7b,2017-03-06,32,3,13,35
air_0867f7bebad6a649,hpg_caf1082b9f445c7b,2017-03-10,6,7,29,13
air_0867f7bebad6a649,hpg_caf1082b9f445c7b,2017-03-17,11,3,33,14
air_0867f7bebad6a649,hpg_caf1082b9f445c7b,2017-03-18,38,4,52,42
air_0867f7bebad6a649,hpg_caf1082b9f445c7b,2017-03-19,12,4,32,16
air_0867f7bebad6a649,hpg_caf1082b9f445c7b,2017-03-22,27,2,30,29
air_0867f7bebad6a649,hpg_caf1082b9f445c7b,2017-03-24,38,40,56,78
air_0867f7bebad6a649,hpg_caf1082b9f445c7b,2017-03-28,35,29,39,64
air_0867f7bebad6a649,hpg_caf1082b9f445c7b,2017-03-31,41,35,48,76
air_0867f7bebad6a649,hpg_caf1082b9f445c7b,2017-04-12,11,11,1,22
air_0867f7bebad6a649,hpg_caf1082b9f445c7b,2017-04-13,6,6,21,12
air_0867f7bebad6a649,hpg_caf1082b9f445c7b,2017-04-16,2,4,3,6
air_0867f7bebad6a649,hpg_caf1082b9f445c7b,2017-04-21,23,20,34,43
air_465bddfed3353b23,hpg_23c5945dc1a72454,2016-10-27,19,19,62,38
air_465bddfed3353b23,hpg_23c5945dc1a72454,2016-10-29,90,49,110,139
air_465bddfed3353b23,hpg_23c5945dc1a72454,2016-11-05,23,4,48,27
air_465bddfed3353b23,hpg_23c5945dc1a72454,2016-11-16,11,10,41,21
air_465bddfed3353b23,hpg_23c5945dc1a72454,2016-11-25,21,21,54,42
air_465bddfed3353b23,hpg_23c5945dc1a72454,2016-12-02,33,33,46,66
air_465bddfed3353b23,hpg_23c5945dc1a72454,2016-12-03,44,29,49,73
air_465bddfed3353b23,hpg_23c5945dc1a72454,2016-12-07,24,24,62,48
air_465bddfed3353b23,hpg_23c5945dc1a72454,2016-12-10,56,10,62,66
air_465bddfed3353b23,hpg_23c5945dc1a72454,2016-12-11,40,6,72,46
air_465bddfed3353b23,hpg_23c5945dc1a72454,2016-12-14,20,20,35,40
air_465bddfed3353b23,hpg_23c5945dc1a72454,2016-12-15,24,51,49,75
air_465bddfed3353b23,hpg_23c5945dc1a72454,2016-12-16,20,55,44,75
air_465bddfed3353b23,hpg_23c5945dc1a72454,2016-12-21,17,26,36,43
air_465bddfed3353b23,hpg_23c5945dc1a72454,2016-12-23,65,20,66,85
air_465bddfed3353b23,hpg_23c5945dc1a72454,2016-12-24,63,2,84,65
air_465bddfed3353b23,hpg_23c5945dc1a72454,2016-12-25,55,42,57,97
air_465bddfed3353b23,hpg_23c5945dc1a72454,2016-12-28,20,31,37,51
air_465bddfed3353b23,hpg_23c5945dc1a72454,2017-01-07,3,18,7,21
air_465bddfed3353b23,hpg_23c5945dc1a72454,2017-01-15,32,5,33,37
air_465bddfed3353b23,hpg_23c5945dc1a72454,2017-01-16,13,13,28,26
air_465bddfed3353b23,hpg_23c5945dc1a72454,2017-01-31,21,2,42,23
air_465bddfed3353b23,hpg_23c5945dc1a72454,2017-02-22,7,2,15,9
air_465bddfed3353b23,hpg_23c5945dc1a72454,2017-03-02,15,15,30,30
air_465bddfed3353b23,hpg_23c5945dc1a72454,2017-03-11,15,20,35,35
air_465bddfed3353b23,hpg_23c5945dc1a72454,2017-03-12,2,2,38,4
air_465bddfed3353b23,hpg_23c5945dc1a72454,2017-03-22,21,21,53,42
air_465bddfed3353b23,hpg_23c5945dc1a72454,2017-03-25,20,40,42,60
air_465bddfed3353b23,hpg_23c5945dc1a72454,2017-03-26,20,4,11,24
air_465bddfed3353b23,hpg_23c5945dc1a72454,2017-04-01,2,2,2,4
air_465bddfed3353b23,hpg_23c5945dc1a72454,2017-04-06,2,2,23,4
air_465bddfed3353b23,hpg_23c5945dc1a72454,2017-04-07,20,40,32,60
air_465bddfed3353b23,hpg_23c5945dc1a72454,2017-04-09,2,2,3,4
air_465bddfed3353b23,hpg_23c5945dc1a72454,2017-04-10,2,23,18,25
air_465bddfed3353b23,hpg_23c5945dc1a72454,2017-04-21,8,8,40,16
air_00a91d42b08b08d9,hpg_fbe603376b5980fc,2016-10-31,2,2,26,4
air_00a91d42b08b08d9,hpg_fbe603376b5980fc,2016-12-05,9,1,33,10
air_00a91d42b08b08d9,hpg_fbe603376b5980fc,2016-12-17,2,2,17,4
air_00a91d42b08b08d9,hpg_fbe603376b5980fc,2016-12-20,4,4,37,8
air_00a91d42b08b08d9,hpg_fbe603376b5980fc,2017-02-18,9,9,18,18
air_00a91d42b08b08d9,hpg_fbe603376b5980fc,2017-02-23,12,12,40,24
air_00a91d42b08b08d9,hpg_fbe603376b5980fc,2017-03-01,3,4,17,7
air_00a91d42b08b08d9,hpg_fbe603376b5980fc,2017-03-14,4,2,28,6
air_00a91d42b08b08d9,hpg_fbe603376b5980fc,2017-03-21,3,3,28,6
air_00a91d42b08b08d9,hpg_fbe603376b5980fc,2017-03-24,2,2,34,4
air_00a91d42b08b08d9,hpg_fbe603376b5980fc,2017-04-04,2,2,17,4
air_97958e7fce98b6a3,hpg_69bfc004fd50cd31,2016-12-17,20,32,64,52
air_97958e7fce98b6a3,hpg_69bfc004fd50cd31,2017-01-05,2,2,6,4
air_97958e7fce98b6a3,hpg_69bfc004fd50cd31,2017-04-17,5,5,20,10
air_32460819c7600037,hpg_ac318be70910278f,2016-01-08,10,8,35,18
air_32460819c7600037,hpg_ac318be70910278f,2016-01-13,17,7,33,24
air_32460819c7600037,hpg_ac318be70910278f,2016-01-20,6,2,36,8
air_32460819c7600037,hpg_ac318be70910278f,2016-01-21,5,5,30,10
air_32460819c7600037,hpg_ac318be70910278f,2016-01-23,13,4,35,17
air_32460819c7600037,hpg_ac318be70910278f,2016-01-25,2,2,17,4
air_32460819c7600037,hpg_ac318be70910278f,2016-02-12,10,2,29,12
air_32460819c7600037,hpg_ac318be70910278f,2016-02-15,8,5,40,13
air_32460819c7600037,hpg_ac318be70910278f,2016-02-24,2,2,37,4
air_32460819c7600037,hpg_ac318be70910278f,2016-03-05,3,3,31,6
air_32460819c7600037,hpg_ac318be70910278f,2016-03-15,16,18,51,34
air_32460819c7600037,hpg_ac318be70910278f,2016-03-18,3,18,51,21
air_32460819c7600037,hpg_ac318be70910278f,2016-03-25,2,2,44,4
air_32460819c7600037,hpg_ac318be70910278f,2016-03-28,2,2,38,4
air_32460819c7600037,hpg_ac318be70910278f,2016-03-30,19,4,55,23
air_32460819c7600037,hpg_ac318be70910278f,2016-04-02,4,4,30,8
air_32460819c7600037,hpg_ac318be70910278f,2016-04-11,14,14,60,28
air_32460819c7600037,hpg_ac318be70910278f,2016-04-14,7,4,55,11
air_32460819c7600037,hpg_ac318be70910278f,2016-04-15,8,16,75,24
air_32460819c7600037,hpg_ac318be70910278f,2016-04-18,2,2,25,4
air_32460819c7600037,hpg_ac318be70910278f,2016-04-19,3,3,33,6
air_32460819c7600037,hpg_ac318be70910278f,2016-04-20,14,4,49,18
air_32460819c7600037,hpg_ac318be70910278f,2016-04-27,4,6,58,10
air_32460819c7600037,hpg_ac318be70910278f,2016-04-28,5,2,44,7
air_32460819c7600037,hpg_ac318be70910278f,2016-04-29,2,2,38,4
air_32460819c7600037,hpg_ac318be70910278f,2016-05-13,4,4,59,8
air_32460819c7600037,hpg_ac318be70910278f,2016-05-18,8,10,60,18
air_32460819c7600037,hpg_ac318be70910278f,2016-05-20,11,6,51,17
air_32460819c7600037,hpg_ac318be70910278f,2016-05-23,9,9,43,18
air_32460819c7600037,hpg_ac318be70910278f,2016-05-24,3,3,53,6
air_32460819c7600037,hpg_ac318be70910278f,2016-05-28,14,7,41,21
air_32460819c7600037,hpg_ac318be70910278f,2016-05-30,27,12,63,39
air_32460819c7600037,hpg_ac318be70910278f,2016-10-28,17,20,53,37
air_32460819c7600037,hpg_ac318be70910278f,2016-10-29,2,2,25,4
air_32460819c7600037,hpg_ac318be70910278f,2016-11-04,6,6,50,12
air_32460819c7600037,hpg_ac318be70910278f,2016-11-09,6,2,37,8
air_32460819c7600037,hpg_ac318be70910278f,2016-11-11,18,4,70,22
air_32460819c7600037,hpg_ac318be70910278f,2016-11-12,2,2,29,4
air_32460819c7600037,hpg_ac318be70910278f,2016-11-17,9,2,42,11
air_32460819c7600037,hpg_ac318be70910278f,2016-11-18,4,4,39,8
air_32460819c7600037,hpg_ac318be70910278f,2016-11-22,14,3,55,17
air_32460819c7600037,hpg_ac318be70910278f,2016-11-24,14,3,51,17
air_32460819c7600037,hpg_ac318be70910278f,2016-11-26,12,2,47,14
air_32460819c7600037,hpg_ac318be70910278f,2016-11-29,21,2,55,23
air_32460819c7600037,hpg_ac318be70910278f,2016-12-02,19,8,63,27
air_32460819c7600037,hpg_ac318be70910278f,2016-12-06,12,9,54,21
air_32460819c7600037,hpg_ac318be70910278f,2016-12-07,13,11,47,24
air_32460819c7600037,hpg_ac318be70910278f,2016-12-08,16,9,48,25
air_32460819c7600037,hpg_ac318be70910278f,2016-12-09,35,8,48,43
air_32460819c7600037,hpg_ac318be70910278f,2016-12-13,8,9,29,17
air_32460819c7600037,hpg_ac318be70910278f,2016-12-14,20,13,58,33
air_32460819c7600037,hpg_ac318be70910278f,2016-12-15,17,28,37,45
air_32460819c7600037,hpg_ac318be70910278f,2016-12-16,28,10,57,38
air_32460819c7600037,hpg_ac318be70910278f,2016-12-17,8,6,34,14
air_32460819c7600037,hpg_ac318be70910278f,2016-12-19,22,7,56,29
air_32460819c7600037,hpg_ac318be70910278f,2016-12-20,20,9,47,29
air_32460819c7600037,hpg_ac318be70910278f,2016-12-21,24,4,66,28
air_32460819c7600037,hpg_ac318be70910278f,2016-12-22,28,17,53,45
air_32460819c7600037,hpg_ac318be70910278f,2016-12-23,14,2,34,16
air_32460819c7600037,hpg_ac318be70910278f,2016-12-24,15,4,40,19
air_32460819c7600037,hpg_ac318be70910278f,2016-12-26,19,21,51,40
air_32460819c7600037,hpg_ac318be70910278f,2016-12-28,15,9,60,24
air_32460819c7600037,hpg_ac318be70910278f,2016-12-29,12,7,46,19
air_32460819c7600037,hpg_ac318be70910278f,2016-12-30,12,4,14,16
air_32460819c7600037,hpg_ac318be70910278f,2017-01-04,3,3,56,6
air_32460819c7600037,hpg_ac318be70910278f,2017-01-07,2,2,15,4
air_32460819c7600037,hpg_ac318be70910278f,2017-01-12,2,2,36,4
air_32460819c7600037,hpg_ac318be70910278f,2017-01-20,17,3,53,20
air_32460819c7600037,hpg_ac318be70910278f,2017-01-21,6,4,24,10
air_32460819c7600037,hpg_ac318be70910278f,2017-01-23,2,2,25,4
air_32460819c7600037,hpg_ac318be70910278f,2017-01-24,55,16,83,71
air_32460819c7600037,hpg_ac318be70910278f,2017-01-25,2,3,42,5
air_32460819c7600037,hpg_ac318be70910278f,2017-01-27,18,8,77,26
air_32460819c7600037,hpg_ac318be70910278f,2017-02-03,16,19,58,35
air_32460819c7600037,hpg_ac318be70910278f,2017-02-08,12,3,57,15
air_32460819c7600037,hpg_ac318be70910278f,2017-02-09,11,4,35,15
air_32460819c7600037,hpg_ac318be70910278f,2017-02-10,11,9,51,20
air_32460819c7600037,hpg_ac318be70910278f,2017-02-14,2,2,45,4
air_32460819c7600037,hpg_ac318be70910278f,2017-02-17,10,10,52,20
air_32460819c7600037,hpg_ac318be70910278f,2017-02-22,15,9,52,24
air_32460819c7600037,hpg_ac318be70910278f,2017-02-24,12,6,59,18
air_32460819c7600037,hpg_ac318be70910278f,2017-02-25,20,2,35,22
air_32460819c7600037,hpg_ac318be70910278f,2017-03-02,4,4,54,8
air_32460819c7600037,hpg_ac318be70910278f,2017-03-03,45,4,76,49
air_32460819c7600037,hpg_ac318be70910278f,2017-03-04,3,4,30,7
air_32460819c7600037,hpg_ac318be70910278f,2017-03-08,5,2,44,7
air_32460819c7600037,hpg_ac318be70910278f,2017-03-09,5,2,53,7
air_32460819c7600037,hpg_ac318be70910278f,2017-03-10,18,6,62,24
air_32460819c7600037,hpg_ac318be70910278f,2017-03-13,14,13,56,27
air_32460819c7600037,hpg_ac318be70910278f,2017-03-14,14,9,61,23
air_32460819c7600037,hpg_ac318be70910278f,2017-03-20,7,7,20,14
air_32460819c7600037,hpg_ac318be70910278f,2017-03-21,13,2,51,15
air_32460819c7600037,hpg_ac318be70910278f,2017-03-23,16,6,56,22
air_32460819c7600037,hpg_ac318be70910278f,2017-03-24,8,6,67,14
air_32460819c7600037,hpg_ac318be70910278f,2017-03-25,10,11,26,21
air_32460819c7600037,hpg_ac318be70910278f,2017-03-27,15,3,49,18
air_32460819c7600037,hpg_ac318be70910278f,2017-03-29,24,6,59,30
air_32460819c7600037,hpg_ac318be70910278f,2017-03-31,21,37,54,58
air_32460819c7600037,hpg_ac318be70910278f,2017-04-06,20,33,52,53
air_32460819c7600037,hpg_ac318be70910278f,2017-04-07,15,8,66,23
air_32460819c7600037,hpg_ac318be70910278f,2017-04-15,8,2,28,10
air_32460819c7600037,hpg_ac318be70910278f,2017-04-21,16,2,69,18
air_32460819c7600037,hpg_ac318be70910278f,2017-04-22,9,2,42,11
air_290e7a57b390f78e,hpg_c5ec63f52e4a7e9e,2016-01-15,13,3,17,16
air_290e7a57b390f78e,hpg_c5ec63f52e4a7e9e,2016-01-18,6,6,6,12
air_290e7a57b390f78e,hpg_c5ec63f52e4a7e9e,2016-01-20,19,3,2,22
air_290e7a57b390f78e,hpg_c5ec63f52e4a7e9e,2016-01-21,16,9,35,25
air_290e7a57b390f78e,hpg_c5ec63f52e4a7e9e,2016-01-25,10,3,12,13
air_290e7a57b390f78e,hpg_c5ec63f52e4a7e9e,2016-01-27,5,3,14,8
air_290e7a57b390f78e,hpg_c5ec63f52e4a7e9e,2016-02-05,14,4,14,18
air_290e7a57b390f78e,hpg_c5ec63f52e4a7e9e,2016-02-12,8,4,16,12
air_290e7a57b390f78e,hpg_c5ec63f52e4a7e9e,2016-02-13,11,2,21,13
air_290e7a57b390f78e,hpg_c5ec63f52e4a7e9e,2016-02-17,13,2,15,15
air_290e7a57b390f78e,hpg_c5ec63f52e4a7e9e,2016-02-26,14,8,17,22
air_290e7a57b390f78e,hpg_c5ec63f52e4a7e9e,2016-03-03,15,4,15,19
air_290e7a57b390f78e,hpg_c5ec63f52e4a7e9e,2016-03-04,16,10,18,26
air_290e7a57b390f78e,hpg_c5ec63f52e4a7e9e,2016-03-09,12,3,16,15
air_290e7a57b390f78e,hpg_c5ec63f52e4a7e9e,2016-03-17,13,2,18,15
air_290e7a57b390f78e,hpg_c5ec63f52e4a7e9e,2016-03-18,18,16,18,34
air_290e7a57b390f78e,hpg_c5ec63f52e4a7e9e,2016-03-23,16,7,12,23
air_290e7a57b390f78e,hpg_c5ec63f52e4a7e9e,2016-03-24,6,2,14,8
air_290e7a57b390f78e,hpg_c5ec63f52e4a7e9e,2016-03-25,12,3,14,15
air_290e7a57b390f78e,hpg_c5ec63f52e4a7e9e,2016-03-30,14,2,16,16
air_290e7a57b390f78e,hpg_c5ec63f52e4a7e9e,2016-03-31,12,3,4,15
air_290e7a57b390f78e,hpg_c5ec63f52e4a7e9e,2016-04-01,17,10,9,27
air_290e7a57b390f78e,hpg_c5ec63f52e4a7e9e,2016-04-05,9,2,9,11
air_290e7a57b390f78e,hpg_c5ec63f52e4a7e9e,2016-04-14,7,2,14,9
air_290e7a57b390f78e,hpg_c5ec63f52e4a7e9e,2016-04-15,10,2,17,12
air_290e7a57b390f78e,hpg_c5ec63f52e4a7e9e,2016-04-18,6,2,7,8
air_290e7a57b390f78e,hpg_c5ec63f52e4a7e9e,2016-04-21,13,4,13,17
air_290e7a57b390f78e,hpg_c5ec63f52e4a7e9e,2016-04-22,16,8,16,24
air_290e7a57b390f78e,hpg_c5ec63f52e4a7e9e,2016-04-23,10,2,10,12
air_290e7a57b390f78e,hpg_c5ec63f52e4a7e9e,2016-05-09,13,2,16,15
air_290e7a57b390f78e,hpg_c5ec63f52e4a7e9e,2016-05-12,14,9,1,23
air_290e7a57b390f78e,hpg_c5ec63f52e4a7e9e,2016-05-13,9,3,32,12
air_290e7a57b390f78e,hpg_c5ec63f52e4a7e9e,2016-05-20,15,3,15,18
air_290e7a57b390f78e,hpg_c5ec63f52e4a7e9e,2016-05-26,4,4,4,8
air_290e7a57b390f78e,hpg_c5ec63f52e4a7e9e,2016-05-30,11,11,11,22
air_290e7a57b390f78e,hpg_c5ec63f52e4a7e9e,2016-06-15,8,2,13,10
air_290e7a57b390f78e,hpg_c5ec63f52e4a7e9e,2016-06-17,14,2,14,16
air_290e7a57b390f78e,hpg_c5ec63f52e4a7e9e,2016-06-21,13,3,13,16
air_290e7a57b390f78e,hpg_c5ec63f52e4a7e9e,2016-06-24,19,6,21,25
air_290e7a57b390f78e,hpg_c5ec63f52e4a7e9e,2016-06-30,8,4,12,12
air_290e7a57b390f78e,hpg_c5ec63f52e4a7e9e,2016-07-01,15,2,15,17
air_290e7a57b390f78e,hpg_c5ec63f52e4a7e9e,2016-11-03,11,11,8,22
air_290e7a57b390f78e,hpg_c5ec63f52e4a7e9e,2016-11-10,9,2,15,11
air_290e7a57b390f78e,hpg_c5ec63f52e4a7e9e,2016-11-12,11,5,14,16
air_290e7a57b390f78e,hpg_c5ec63f52e4a7e9e,2016-11-17,10,2,12,12
air_290e7a57b390f78e,hpg_c5ec63f52e4a7e9e,2016-11-18,9,3,12,12
air_290e7a57b390f78e,hpg_c5ec63f52e4a7e9e,2016-11-22,14,3,16,17
air_290e7a57b390f78e,hpg_c5ec63f52e4a7e9e,2016-11-24,8,5,8,13
air_290e7a57b390f78e,hpg_c5ec63f52e4a7e9e,2016-11-25,20,10,20,30
air_290e7a57b390f78e,hpg_c5ec63f52e4a7e9e,2016-12-01,11,9,13,20
air_290e7a57b390f78e,hpg_c5ec63f52e4a7e9e,2016-12-02,19,5,20,24
air_290e7a57b390f78e,hpg_c5ec63f52e4a7e9e,2016-12-07,9,12,12,21
air_290e7a57b390f78e,hpg_c5ec63f52e4a7e9e,2016-12-09,17,5,17,22
air_290e7a57b390f78e,hpg_c5ec63f52e4a7e9e,2016-12-13,13,2,13,15
air_290e7a57b390f78e,hpg_c5ec63f52e4a7e9e,2016-12-14,12,2,12,14
air_290e7a57b390f78e,hpg_c5ec63f52e4a7e9e,2016-12-15,19,4,17,23
air_290e7a57b390f78e,hpg_c5ec63f52e4a7e9e,2016-12-20,15,14,17,29
air_290e7a57b390f78e,hpg_c5ec63f52e4a7e9e,2016-12-23,10,4,15,14
air_290e7a57b390f78e,hpg_c5ec63f52e4a7e9e,2016-12-24,17,4,17,21
air_290e7a57b390f78e,hpg_c5ec63f52e4a7e9e,2016-12-30,8,4,6,12
air_290e7a57b390f78e,hpg_c5ec63f52e4a7e9e,2017-01-06,8,2,13,10
air_290e7a57b390f78e,hpg_c5ec63f52e4a7e9e,2017-01-07,4,2,5,6
air_290e7a57b390f78e,hpg_c5ec63f52e4a7e9e,2017-01-16,5,3,7,8
air_290e7a57b390f78e,hpg_c5ec63f52e4a7e9e,2017-01-17,9,2,13,11
air_290e7a57b390f78e,hpg_c5ec63f52e4a7e9e,2017-01-18,12,2,13,14
air_290e7a57b390f78e,hpg_c5ec63f52e4a7e9e,2017-01-26,8,6,9,14
air_290e7a57b390f78e,hpg_c5ec63f52e4a7e9e,2017-01-28,18,2,18,20
air_290e7a57b390f78e,hpg_c5ec63f52e4a7e9e,2017-02-02,4,3,9,7
air_290e7a57b390f78e,hpg_c5ec63f52e4a7e9e,2017-02-03,12,4,12,16
air_290e7a57b390f78e,hpg_c5ec63f52e4a7e9e,2017-02-11,15,2,20,17
air_290e7a57b390f78e,hpg_c5ec63f52e4a7e9e,2017-02-13,4,2,7,6
air_290e7a57b390f78e,hpg_c5ec63f52e4a7e9e,2017-02-14,15,4,17,19
air_290e7a57b390f78e,hpg_c5ec63f52e4a7e9e,2017-02-16,5,12,15,17
air_290e7a57b390f78e,hpg_c5ec63f52e4a7e9e,2017-02-17,18,4,18,22
air_290e7a57b390f78e,hpg_c5ec63f52e4a7e9e,2017-02-20,15,8,12,23
air_290e7a57b390f78e,hpg_c5ec63f52e4a7e9e,2017-02-23,16,3,17,19
air_290e7a57b390f78e,hpg_c5ec63f52e4a7e9e,2017-02-24,16,5,14,21
air_290e7a57b390f78e,hpg_c5ec63f52e4a7e9e,2017-02-28,13,8,15,21
air_290e7a57b390f78e,hpg_c5ec63f52e4a7e9e,2017-03-02,6,2,9,8
air_290e7a57b390f78e,hpg_c5ec63f52e4a7e9e,2017-03-03,9,5,9,14
air_290e7a57b390f78e,hpg_c5ec63f52e4a7e9e,2017-03-21,15,5,15,20
air_290e7a57b390f78e,hpg_c5ec63f52e4a7e9e,2017-03-29,16,7,18,23
air_290e7a57b390f78e,hpg_c5ec63f52e4a7e9e,2017-04-01,7,2,8,9
air_290e7a57b390f78e,hpg_c5ec63f52e4a7e9e,2017-04-17,8,2,12,10
air_290e7a57b390f78e,hpg_c5ec63f52e4a7e9e,2017-04-19,12,6,16,18
air_290e7a57b390f78e,hpg_c5ec63f52e4a7e9e,2017-04-21,14,7,34,21
air_2b8b29ddfd35018e,hpg_2d4200d0ebdb4946,2016-01-26,4,4,17,8
air_2b8b29ddfd35018e,hpg_2d4200d0ebdb4946,2016-02-19,2,2,11,4
air_2b8b29ddfd35018e,hpg_2d4200d0ebdb4946,2016-02-25,2,2,4,4
air_2b8b29ddfd35018e,hpg_2d4200d0ebdb4946,2016-03-04,2,6,27,8
air_2b8b29ddfd35018e,hpg_2d4200d0ebdb4946,2016-03-19,14,4,33,18
air_2b8b29ddfd35018e,hpg_2d4200d0ebdb4946,2016-03-22,9,2,6,11
air_2b8b29ddfd35018e,hpg_2d4200d0ebdb4946,2016-03-23,9,6,29,15
air_2b8b29ddfd35018e,hpg_2d4200d0ebdb4946,2016-03-26,13,2,19,15
air_2b8b29ddfd35018e,hpg_2d4200d0ebdb4946,2016-04-14,6,6,13,12
air_2b8b29ddfd35018e,hpg_2d4200d0ebdb4946,2016-04-30,9,2,31,11
air_2b8b29ddfd35018e,hpg_2d4200d0ebdb4946,2016-05-02,7,4,10,11
air_2b8b29ddfd35018e,hpg_2d4200d0ebdb4946,2016-05-12,4,4,13,8
air_2b8b29ddfd35018e,hpg_2d4200d0ebdb4946,2016-05-28,5,3,17,8
air_2b8b29ddfd35018e,hpg_2d4200d0ebdb4946,2016-06-03,4,4,25,8
air_2b8b29ddfd35018e,hpg_2d4200d0ebdb4946,2016-06-04,2,2,17,4
air_2b8b29ddfd35018e,hpg_2d4200d0ebdb4946,2016-06-11,7,4,18,11
air_2b8b29ddfd35018e,hpg_2d4200d0ebdb4946,2016-06-17,4,2,18,6
air_2b8b29ddfd35018e,hpg_2d4200d0ebdb4946,2016-06-23,18,18,4,36
air_2b8b29ddfd35018e,hpg_2d4200d0ebdb4946,2016-06-25,6,2,26,8
air_2b8b29ddfd35018e,hpg_2d4200d0ebdb4946,2016-07-06,7,2,13,9
air_2b8b29ddfd35018e,hpg_2d4200d0ebdb4946,2016-10-28,5,5,4,10
air_2b8b29ddfd35018e,hpg_2d4200d0ebdb4946,2016-10-29,7,5,31,12
air_2b8b29ddfd35018e,hpg_2d4200d0ebdb4946,2016-11-02,2,2,10,4
air_2b8b29ddfd35018e,hpg_2d4200d0ebdb4946,2016-11-30,2,2,5,4
air_2b8b29ddfd35018e,hpg_2d4200d0ebdb4946,2016-12-03,7,3,27,10
air_2b8b29ddfd35018e,hpg_2d4200d0ebdb4946,2016-12-12,14,2,34,16
air_2b8b29ddfd35018e,hpg_2d4200d0ebdb4946,2016-12-18,6,6,31,12
air_2b8b29ddfd35018e,hpg_2d4200d0ebdb4946,2016-12-22,9,7,17,16
air_2b8b29ddfd35018e,hpg_2d4200d0ebdb4946,2016-12-28,11,7,23,18
air_2b8b29ddfd35018e,hpg_2d4200d0ebdb4946,2016-12-29,7,2,19,9
air_2b8b29ddfd35018e,hpg_2d4200d0ebdb4946,2017-01-21,5,2,17,7
air_2b8b29ddfd35018e,hpg_2d4200d0ebdb4946,2017-01-28,6,6,24,12
air_2b8b29ddfd35018e,hpg_2d4200d0ebdb4946,2017-02-03,10,6,14,16
air_2b8b29ddfd35018e,hpg_2d4200d0ebdb4946,2017-02-23,8,8,13,16
air_2b8b29ddfd35018e,hpg_2d4200d0ebdb4946,2017-02-24,14,7,15,21
air_2b8b29ddfd35018e,hpg_2d4200d0ebdb4946,2017-03-09,7,7,12,14
air_2b8b29ddfd35018e,hpg_2d4200d0ebdb4946,2017-03-11,11,6,36,17
air_2b8b29ddfd35018e,hpg_2d4200d0ebdb4946,2017-03-18,5,5,43,10
air_2b8b29ddfd35018e,hpg_2d4200d0ebdb4946,2017-03-24,11,4,17,15
air_2b8b29ddfd35018e,hpg_2d4200d0ebdb4946,2017-03-25,8,2,21,10
air_2b8b29ddfd35018e,hpg_2d4200d0ebdb4946,2017-04-04,5,2,10,7
air_2b8b29ddfd35018e,hpg_2d4200d0ebdb4946,2017-04-05,7,2,14,9
air_2b8b29ddfd35018e,hpg_2d4200d0ebdb4946,2017-04-14,5,5,22,10
air_2b8b29ddfd35018e,hpg_2d4200d0ebdb4946,2017-04-21,2,2,12,4
air_fdc02ec4a3d21ea4,hpg_528734c946fae58b,2016-11-16,3,3,16,6
air_fdc02ec4a3d21ea4,hpg_528734c946fae58b,2016-12-10,9,2,61,11
air_fdc02ec4a3d21ea4,hpg_528734c946fae58b,2016-12-18,4,4,28,8
air_fdc02ec4a3d21ea4,hpg_528734c946fae58b,2016-12-22,18,13,29,31
air_fdc02ec4a3d21ea4,hpg_528734c946fae58b,2016-12-26,8,8,36,16
air_fdc02ec4a3d21ea4,hpg_528734c946fae58b,2017-01-04,2,2,5,4
air_fdc02ec4a3d21ea4,hpg_528734c946fae58b,2017-01-18,5,5,24,10
air_fdc02ec4a3d21ea4,hpg_528734c946fae58b,2017-01-20,4,4,27,8
air_fdc02ec4a3d21ea4,hpg_528734c946fae58b,2017-01-25,2,2,21,4
air_fdc02ec4a3d21ea4,hpg_528734c946fae58b,2017-03-11,2,2,44,4
air_fdc02ec4a3d21ea4,hpg_528734c946fae58b,2017-04-01,2,2,14,4
air_638c35eb25e53eea,hpg_f07ec7b288165b27,2016-11-23,2,2,20,4
air_638c35eb25e53eea,hpg_f07ec7b288165b27,2017-04-18,4,4,26,8
air_638c35eb25e53eea,hpg_f07ec7b288165b27,2017-04-22,2,2,51,4
air_15ae33469e9ea2dd,hpg_fa4eeada9ad7b59f,2016-11-28,6,10,9,16
air_15ae33469e9ea2dd,hpg_fa4eeada9ad7b59f,2017-01-13,8,4,29,12
air_90213bcae4afa274,hpg_33df7b58b0f9d93f,2016-11-16,12,4,25,16
air_90213bcae4afa274,hpg_33df7b58b0f9d93f,2016-11-18,5,4,31,9
air_90213bcae4afa274,hpg_33df7b58b0f9d93f,2016-11-22,9,5,31,14
air_90213bcae4afa274,hpg_33df7b58b0f9d93f,2016-11-28,13,7,39,20
air_90213bcae4afa274,hpg_33df7b58b0f9d93f,2016-12-12,20,16,36,36
air_90213bcae4afa274,hpg_33df7b58b0f9d93f,2016-12-22,2,2,50,4
air_90213bcae4afa274,hpg_33df7b58b0f9d93f,2016-12-24,5,5,17,10
air_90213bcae4afa274,hpg_33df7b58b0f9d93f,2017-03-07,7,9,32,16
air_b9e27558fb8bd5c4,hpg_43a5666d1b6fa70b,2016-01-09,14,2,5,16
air_b9e27558fb8bd5c4,hpg_43a5666d1b6fa70b,2016-01-15,12,2,19,14
air_b9e27558fb8bd5c4,hpg_43a5666d1b6fa70b,2016-01-23,22,15,25,37
air_b9e27558fb8bd5c4,hpg_43a5666d1b6fa70b,2016-01-27,18,3,21,21
air_b9e27558fb8bd5c4,hpg_43a5666d1b6fa70b,2016-01-29,16,2,25,18
air_b9e27558fb8bd5c4,hpg_43a5666d1b6fa70b,2016-02-26,10,2,22,12
air_b9e27558fb8bd5c4,hpg_43a5666d1b6fa70b,2016-03-16,6,4,15,10
air_b9e27558fb8bd5c4,hpg_43a5666d1b6fa70b,2016-11-24,4,2,5,6
air_b9e27558fb8bd5c4,hpg_43a5666d1b6fa70b,2016-12-08,10,3,12,13
air_b9e27558fb8bd5c4,hpg_43a5666d1b6fa70b,2016-12-09,23,2,30,25
air_b9e27558fb8bd5c4,hpg_43a5666d1b6fa70b,2016-12-26,10,5,16,15
air_b9e27558fb8bd5c4,hpg_43a5666d1b6fa70b,2017-01-10,3,3,11,6
air_b9e27558fb8bd5c4,hpg_43a5666d1b6fa70b,2017-01-17,7,7,12,14
air_b9e27558fb8bd5c4,hpg_43a5666d1b6fa70b,2017-01-28,10,10,17,20
air_b9e27558fb8bd5c4,hpg_43a5666d1b6fa70b,2017-02-17,10,2,24,12
air_b9e27558fb8bd5c4,hpg_43a5666d1b6fa70b,2017-02-21,21,2,23,23
air_b9e27558fb8bd5c4,hpg_43a5666d1b6fa70b,2017-02-25,14,4,13,18
air_b9e27558fb8bd5c4,hpg_43a5666d1b6fa70b,2017-02-27,5,3,13,8
air_b9e27558fb8bd5c4,hpg_43a5666d1b6fa70b,2017-03-06,5,2,12,7
air_b9e27558fb8bd5c4,hpg_43a5666d1b6fa70b,2017-03-16,11,6,16,17
air_b9e27558fb8bd5c4,hpg_43a5666d1b6fa70b,2017-03-17,14,3,17,17
air_b9e27558fb8bd5c4,hpg_43a5666d1b6fa70b,2017-03-24,8,3,12,11
air_b9e27558fb8bd5c4,hpg_43a5666d1b6fa70b,2017-04-07,9,4,12,13
air_b9e27558fb8bd5c4,hpg_43a5666d1b6fa70b,2017-04-08,2,2,13,4
air_4433ab8e9999915f,hpg_a214a6b219c6649c,2016-11-24,6,6,15,12
air_4433ab8e9999915f,hpg_a214a6b219c6649c,2016-12-10,2,2,17,4
air_4433ab8e9999915f,hpg_a214a6b219c6649c,2017-03-01,4,4,22,8
air_b8925441167c3152,hpg_0cc0abae3a8b52de,2016-12-16,10,6,18,16
air_b8925441167c3152,hpg_0cc0abae3a8b52de,2016-12-24,2,2,6,4
air_89e7328af22efe74,hpg_2cad4924680c2a1e,2016-10-29,20,14,81,34
air_89e7328af22efe74,hpg_2cad4924680c2a1e,2016-10-30,17,2,62,19
air_89e7328af22efe74,hpg_2cad4924680c2a1e,2016-10-31,3,5,19,8
air_89e7328af22efe74,hpg_2cad4924680c2a1e,2016-11-05,5,2,79,7
air_89e7328af22efe74,hpg_2cad4924680c2a1e,2016-11-06,6,3,50,9
air_89e7328af22efe74,hpg_2cad4924680c2a1e,2016-11-07,8,2,48,10
air_89e7328af22efe74,hpg_2cad4924680c2a1e,2016-11-10,2,3,18,5
air_89e7328af22efe74,hpg_2cad4924680c2a1e,2016-11-12,15,3,67,18
air_89e7328af22efe74,hpg_2cad4924680c2a1e,2016-11-19,8,6,71,14
air_89e7328af22efe74,hpg_2cad4924680c2a1e,2016-11-21,11,2,24,13
air_89e7328af22efe74,hpg_2cad4924680c2a1e,2016-11-25,4,2,38,6
air_89e7328af22efe74,hpg_2cad4924680c2a1e,2016-11-26,45,2,74,47
air_89e7328af22efe74,hpg_2cad4924680c2a1e,2016-11-27,8,6,41,14
air_89e7328af22efe74,hpg_2cad4924680c2a1e,2016-11-28,4,4,24,8
air_89e7328af22efe74,hpg_2cad4924680c2a1e,2016-12-02,2,2,35,4
air_89e7328af22efe74,hpg_2cad4924680c2a1e,2016-12-03,8,6,64,14
air_89e7328af22efe74,hpg_2cad4924680c2a1e,2016-12-04,7,2,54,9
air_89e7328af22efe74,hpg_2cad4924680c2a1e,2016-12-10,20,26,60,46
air_89e7328af22efe74,hpg_2cad4924680c2a1e,2016-12-11,15,10,74,25
air_89e7328af22efe74,hpg_2cad4924680c2a1e,2016-12-12,7,4,28,11
air_89e7328af22efe74,hpg_2cad4924680c2a1e,2016-12-16,21,4,46,25
air_89e7328af22efe74,hpg_2cad4924680c2a1e,2016-12-17,20,16,73,36
air_89e7328af22efe74,hpg_2cad4924680c2a1e,2016-12-18,8,4,45,12
air_89e7328af22efe74,hpg_2cad4924680c2a1e,2016-12-23,23,3,52,26
air_89e7328af22efe74,hpg_2cad4924680c2a1e,2016-12-24,17,46,59,63
air_89e7328af22efe74,hpg_2cad4924680c2a1e,2016-12-25,14,22,44,36
air_89e7328af22efe74,hpg_2cad4924680c2a1e,2017-01-07,5,5,43,10
air_89e7328af22efe74,hpg_2cad4924680c2a1e,2017-01-09,2,6,24,8
air_89e7328af22efe74,hpg_2cad4924680c2a1e,2017-01-13,10,8,34,18
air_89e7328af22efe74,hpg_2cad4924680c2a1e,2017-01-22,6,2,48,8
air_89e7328af22efe74,hpg_2cad4924680c2a1e,2017-01-28,8,4,79,12
air_89e7328af22efe74,hpg_2cad4924680c2a1e,2017-02-06,3,3,14,6
air_89e7328af22efe74,hpg_2cad4924680c2a1e,2017-02-11,4,2,72,6
air_89e7328af22efe74,hpg_2cad4924680c2a1e,2017-02-12,8,6,62,14
air_89e7328af22efe74,hpg_2cad4924680c2a1e,2017-02-18,15,2,66,17
air_89e7328af22efe74,hpg_2cad4924680c2a1e,2017-02-19,14,4,57,18
air_89e7328af22efe74,hpg_2cad4924680c2a1e,2017-02-24,4,4,43,8
air_89e7328af22efe74,hpg_2cad4924680c2a1e,2017-02-25,7,5,76,12
air_89e7328af22efe74,hpg_2cad4924680c2a1e,2017-02-27,11,3,35,14
air_89e7328af22efe74,hpg_2cad4924680c2a1e,2017-03-02,3,3,26,6
air_89e7328af22efe74,hpg_2cad4924680c2a1e,2017-03-03,3,3,19,6
air_89e7328af22efe74,hpg_2cad4924680c2a1e,2017-03-04,10,18,67,28
air_89e7328af22efe74,hpg_2cad4924680c2a1e,2017-03-05,13,4,71,17
air_89e7328af22efe74,hpg_2cad4924680c2a1e,2017-03-10,6,2,38,8
air_89e7328af22efe74,hpg_2cad4924680c2a1e,2017-03-11,21,8,84,29
air_89e7328af22efe74,hpg_2cad4924680c2a1e,2017-03-12,8,5,60,13
air_89e7328af22efe74,hpg_2cad4924680c2a1e,2017-03-17,7,5,28,12
air_89e7328af22efe74,hpg_2cad4924680c2a1e,2017-03-18,8,5,71,13
air_89e7328af22efe74,hpg_2cad4924680c2a1e,2017-03-19,19,2,75,21
air_89e7328af22efe74,hpg_2cad4924680c2a1e,2017-03-20,7,3,54,10
air_89e7328af22efe74,hpg_2cad4924680c2a1e,2017-03-23,18,4,37,22
air_89e7328af22efe74,hpg_2cad4924680c2a1e,2017-03-24,6,4,35,10
air_89e7328af22efe74,hpg_2cad4924680c2a1e,2017-03-25,22,19,68,41
air_89e7328af22efe74,hpg_2cad4924680c2a1e,2017-03-27,9,6,38,15
air_89e7328af22efe74,hpg_2cad4924680c2a1e,2017-03-30,6,6,33,12
air_89e7328af22efe74,hpg_2cad4924680c2a1e,2017-03-31,8,5,35,13
air_89e7328af22efe74,hpg_2cad4924680c2a1e,2017-04-01,20,2,59,22
air_89e7328af22efe74,hpg_2cad4924680c2a1e,2017-04-02,7,2,61,9
air_89e7328af22efe74,hpg_2cad4924680c2a1e,2017-04-03,6,6,17,12
air_89e7328af22efe74,hpg_2cad4924680c2a1e,2017-04-06,4,2,14,6
air_89e7328af22efe74,hpg_2cad4924680c2a1e,2017-04-08,3,3,56,6
air_89e7328af22efe74,hpg_2cad4924680c2a1e,2017-04-09,16,10,53,26
air_89e7328af22efe74,hpg_2cad4924680c2a1e,2017-04-13,11,5,21,16
air_89e7328af22efe74,hpg_2cad4924680c2a1e,2017-04-15,17,9,65,26
air_89e7328af22efe74,hpg_2cad4924680c2a1e,2017-04-16,24,11,61,35
air_89e7328af22efe74,hpg_2cad4924680c2a1e,2017-04-20,9,4,22,13
air_89e7328af22efe74,hpg_2cad4924680c2a1e,2017-04-22,19,9,77,28
air_2aab19554f91ff82,hpg_cac091abfcee2a85,2016-01-22,2,2,31,4
air_2aab19554f91ff82,hpg_cac091abfcee2a85,2016-02-19,2,2,30,4
air_2aab19554f91ff82,hpg_cac091abfcee2a85,2016-03-09,5,3,19,8
air_2aab19554f91ff82,hpg_cac091abfcee2a85,2016-03-12,9,3,9,12
air_2aab19554f91ff82,hpg_cac091abfcee2a85,2016-03-17,3,2,38,5
air_2aab19554f91ff82,hpg_cac091abfcee2a85,2016-03-18,28,6,72,34
air_2aab19554f91ff82,hpg_cac091abfcee2a85,2016-03-23,20,4,53,24
air_2aab19554f91ff82,hpg_cac091abfcee2a85,2016-03-24,19,2,44,21
air_2aab19554f91ff82,hpg_cac091abfcee2a85,2016-03-25,25,12,54,37
air_2aab19554f91ff82,hpg_cac091abfcee2a85,2016-03-26,14,2,23,16
air_2aab19554f91ff82,hpg_cac091abfcee2a85,2016-03-28,7,4,33,11
air_2aab19554f91ff82,hpg_cac091abfcee2a85,2016-03-30,10,2,41,12
air_2aab19554f91ff82,hpg_cac091abfcee2a85,2016-04-01,17,7,61,24
air_2aab19554f91ff82,hpg_cac091abfcee2a85,2016-04-11,13,3,41,16
air_2aab19554f91ff82,hpg_cac091abfcee2a85,2016-04-14,19,7,45,26
air_2aab19554f91ff82,hpg_cac091abfcee2a85,2016-04-15,18,2,47,20
air_2aab19554f91ff82,hpg_cac091abfcee2a85,2016-04-20,15,2,39,17
air_2aab19554f91ff82,hpg_cac091abfcee2a85,2016-04-30,5,2,14,7
air_2aab19554f91ff82,hpg_cac091abfcee2a85,2016-05-11,10,8,40,18
air_2aab19554f91ff82,hpg_cac091abfcee2a85,2016-05-26,8,2,40,10
air_2aab19554f91ff82,hpg_cac091abfcee2a85,2016-05-27,27,9,55,36
air_2aab19554f91ff82,hpg_cac091abfcee2a85,2016-06-02,16,4,42,20
air_2aab19554f91ff82,hpg_cac091abfcee2a85,2016-06-03,21,15,50,36
air_2aab19554f91ff82,hpg_cac091abfcee2a85,2016-06-04,12,5,16,17
air_2aab19554f91ff82,hpg_cac091abfcee2a85,2016-06-07,2,2,23,4
air_2aab19554f91ff82,hpg_cac091abfcee2a85,2016-06-08,8,3,24,11
air_2aab19554f91ff82,hpg_cac091abfcee2a85,2016-06-09,17,4,42,21
air_2aab19554f91ff82,hpg_cac091abfcee2a85,2016-06-10,14,5,54,19
air_2aab19554f91ff82,hpg_cac091abfcee2a85,2016-06-13,4,4,20,8
air_2aab19554f91ff82,hpg_cac091abfcee2a85,2016-06-16,5,3,45,8
air_2aab19554f91ff82,hpg_cac091abfcee2a85,2016-06-17,10,2,41,12
air_2aab19554f91ff82,hpg_cac091abfcee2a85,2016-06-18,2,8,14,10
air_2aab19554f91ff82,hpg_cac091abfcee2a85,2016-06-22,9,2,37,11
air_2aab19554f91ff82,hpg_cac091abfcee2a85,2016-06-24,17,4,44,21
air_2aab19554f91ff82,hpg_cac091abfcee2a85,2016-06-28,15,5,31,20
air_2aab19554f91ff82,hpg_cac091abfcee2a85,2016-06-29,14,2,45,16
air_2aab19554f91ff82,hpg_cac091abfcee2a85,2016-07-01,4,2,42,6
air_2aab19554f91ff82,hpg_cac091abfcee2a85,2016-07-02,2,2,2,4
air_2aab19554f91ff82,hpg_cac091abfcee2a85,2016-07-04,6,2,27,8
air_2aab19554f91ff82,hpg_cac091abfcee2a85,2016-10-28,13,2,49,15
air_2aab19554f91ff82,hpg_cac091abfcee2a85,2016-10-29,10,3,15,13
air_2aab19554f91ff82,hpg_cac091abfcee2a85,2016-11-03,6,2,8,8
air_2aab19554f91ff82,hpg_cac091abfcee2a85,2016-11-04,12,4,31,16
air_2aab19554f91ff82,hpg_cac091abfcee2a85,2016-11-07,7,2,22,9
air_2aab19554f91ff82,hpg_cac091abfcee2a85,2016-11-08,14,2,53,16
air_2aab19554f91ff82,hpg_cac091abfcee2a85,2016-11-15,8,2,31,10
air_2aab19554f91ff82,hpg_cac091abfcee2a85,2016-11-18,27,3,71,30
air_2aab19554f91ff82,hpg_cac091abfcee2a85,2016-11-25,12,9,48,21
air_2aab19554f91ff82,hpg_cac091abfcee2a85,2016-11-30,24,3,41,27
air_2aab19554f91ff82,hpg_cac091abfcee2a85,2016-12-01,11,2,42,13
air_2aab19554f91ff82,hpg_cac091abfcee2a85,2016-12-02,15,8,26,23
air_2aab19554f91ff82,hpg_cac091abfcee2a85,2016-12-03,8,2,12,10
air_2aab19554f91ff82,hpg_cac091abfcee2a85,2016-12-06,16,7,56,23
air_2aab19554f91ff82,hpg_cac091abfcee2a85,2016-12-09,22,5,50,27
air_2aab19554f91ff82,hpg_cac091abfcee2a85,2016-12-12,13,9,45,22
air_2aab19554f91ff82,hpg_cac091abfcee2a85,2016-12-13,8,3,48,11
air_2aab19554f91ff82,hpg_cac091abfcee2a85,2016-12-14,19,18,61,37
air_2aab19554f91ff82,hpg_cac091abfcee2a85,2016-12-16,27,55,50,82
air_2aab19554f91ff82,hpg_cac091abfcee2a85,2016-12-19,11,2,57,13
air_2aab19554f91ff82,hpg_cac091abfcee2a85,2016-12-21,22,8,76,30
air_2aab19554f91ff82,hpg_cac091abfcee2a85,2016-12-22,33,52,71,85
air_2aab19554f91ff82,hpg_cac091abfcee2a85,2016-12-23,20,4,24,24
air_2aab19554f91ff82,hpg_cac091abfcee2a85,2016-12-24,20,5,32,25
air_2aab19554f91ff82,hpg_cac091abfcee2a85,2016-12-26,15,2,50,17
air_2aab19554f91ff82,hpg_cac091abfcee2a85,2016-12-27,13,7,58,20
air_2aab19554f91ff82,hpg_cac091abfcee2a85,2016-12-28,20,2,74,22
air_2aab19554f91ff82,hpg_cac091abfcee2a85,2017-01-12,8,2,38,10
air_2aab19554f91ff82,hpg_cac091abfcee2a85,2017-01-13,9,2,57,11
air_2aab19554f91ff82,hpg_cac091abfcee2a85,2017-01-17,7,2,44,9
air_2aab19554f91ff82,hpg_cac091abfcee2a85,2017-01-20,11,6,46,17
air_2aab19554f91ff82,hpg_cac091abfcee2a85,2017-01-21,2,2,6,4
air_2aab19554f91ff82,hpg_cac091abfcee2a85,2017-01-24,20,6,55,26
air_2aab19554f91ff82,hpg_cac091abfcee2a85,2017-01-25,14,8,51,22
air_2aab19554f91ff82,hpg_cac091abfcee2a85,2017-01-26,9,4,68,13
air_2aab19554f91ff82,hpg_cac091abfcee2a85,2017-01-27,17,4,63,21
air_2aab19554f91ff82,hpg_cac091abfcee2a85,2017-01-28,2,2,12,4
air_2aab19554f91ff82,hpg_cac091abfcee2a85,2017-01-30,8,2,42,10
air_2aab19554f91ff82,hpg_cac091abfcee2a85,2017-02-03,2,2,56,4
air_2aab19554f91ff82,hpg_cac091abfcee2a85,2017-02-09,10,2,48,12
air_2aab19554f91ff82,hpg_cac091abfcee2a85,2017-02-11,6,4,10,10
air_2aab19554f91ff82,hpg_cac091abfcee2a85,2017-02-14,9,2,47,11
air_2aab19554f91ff82,hpg_cac091abfcee2a85,2017-02-16,6,2,39,8
air_2aab19554f91ff82,hpg_cac091abfcee2a85,2017-02-17,14,5,70,19
air_2aab19554f91ff82,hpg_cac091abfcee2a85,2017-02-18,4,4,12,8
air_2aab19554f91ff82,hpg_cac091abfcee2a85,2017-02-21,13,3,46,16
air_2aab19554f91ff82,hpg_cac091abfcee2a85,2017-02-22,13,3,48,16
air_2aab19554f91ff82,hpg_cac091abfcee2a85,2017-02-24,25,17,87,42
air_2aab19554f91ff82,hpg_cac091abfcee2a85,2017-02-25,5,2,11,7
air_2aab19554f91ff82,hpg_cac091abfcee2a85,2017-03-03,17,2,60,19
air_2aab19554f91ff82,hpg_cac091abfcee2a85,2017-03-09,17,2,62,19
air_2aab19554f91ff82,hpg_cac091abfcee2a85,2017-03-10,21,12,57,33
air_2aab19554f91ff82,hpg_cac091abfcee2a85,2017-03-11,7,2,12,9
air_2aab19554f91ff82,hpg_cac091abfcee2a85,2017-03-13,4,7,39,11
air_2aab19554f91ff82,hpg_cac091abfcee2a85,2017-03-15,6,5,62,11
air_2aab19554f91ff82,hpg_cac091abfcee2a85,2017-03-17,11,3,77,14
air_2aab19554f91ff82,hpg_cac091abfcee2a85,2017-03-22,13,3,57,16
air_2aab19554f91ff82,hpg_cac091abfcee2a85,2017-03-23,6,4,50,10
air_2aab19554f91ff82,hpg_cac091abfcee2a85,2017-03-24,18,9,70,27
air_2aab19554f91ff82,hpg_cac091abfcee2a85,2017-03-29,22,4,66,26
air_2aab19554f91ff82,hpg_cac091abfcee2a85,2017-03-31,6,8,74,14
air_2aab19554f91ff82,hpg_cac091abfcee2a85,2017-04-03,7,7,56,14
air_2aab19554f91ff82,hpg_cac091abfcee2a85,2017-04-06,24,7,70,31
air_2aab19554f91ff82,hpg_cac091abfcee2a85,2017-04-08,8,2,16,10
air_2aab19554f91ff82,hpg_cac091abfcee2a85,2017-04-11,12,4,53,16
air_2aab19554f91ff82,hpg_cac091abfcee2a85,2017-04-12,12,2,67,14
air_2aab19554f91ff82,hpg_cac091abfcee2a85,2017-04-19,4,3,53,7
air_2aab19554f91ff82,hpg_cac091abfcee2a85,2017-04-22,4,4,9,8
air_6b942d5ebbc759c2,hpg_3253426a007cf3eb,2016-11-10,7,7,22,14
air_6b942d5ebbc759c2,hpg_3253426a007cf3eb,2016-11-25,10,10,27,20
air_6b942d5ebbc759c2,hpg_3253426a007cf3eb,2016-12-02,17,8,31,25
air_6b942d5ebbc759c2,hpg_3253426a007cf3eb,2016-12-03,8,2,25,10
air_6b942d5ebbc759c2,hpg_3253426a007cf3eb,2016-12-07,17,2,25,19
air_6b942d5ebbc759c2,hpg_3253426a007cf3eb,2016-12-09,7,7,31,14
air_6b942d5ebbc759c2,hpg_3253426a007cf3eb,2016-12-16,17,20,39,37
air_6b942d5ebbc759c2,hpg_3253426a007cf3eb,2016-12-17,24,13,34,37
air_6b942d5ebbc759c2,hpg_3253426a007cf3eb,2016-12-29,13,10,33,23
air_6b942d5ebbc759c2,hpg_3253426a007cf3eb,2016-12-30,26,4,39,30
air_6b942d5ebbc759c2,hpg_3253426a007cf3eb,2017-02-09,8,8,14,16
air_6b942d5ebbc759c2,hpg_3253426a007cf3eb,2017-02-11,6,3,19,9
air_6b942d5ebbc759c2,hpg_3253426a007cf3eb,2017-04-14,23,23,37,46
air_6b942d5ebbc759c2,hpg_3253426a007cf3eb,2017-04-21,19,11,21,30
air_c759b6abeb552160,hpg_e6d06810b701ab12,2016-02-12,5,5,4,10
air_c759b6abeb552160,hpg_e6d06810b701ab12,2016-02-20,3,3,6,6
air_c759b6abeb552160,hpg_e6d06810b701ab12,2016-03-01,2,2,2,4
air_c759b6abeb552160,hpg_e6d06810b701ab12,2016-03-12,20,20,2,40
air_c759b6abeb552160,hpg_e6d06810b701ab12,2016-03-15,11,11,13,22
air_c759b6abeb552160,hpg_e6d06810b701ab12,2016-03-19,5,5,21,10
air_c759b6abeb552160,hpg_e6d06810b701ab12,2016-03-24,25,25,9,50
air_c759b6abeb552160,hpg_e6d06810b701ab12,2016-03-25,15,15,40,30
air_c759b6abeb552160,hpg_e6d06810b701ab12,2016-03-26,22,30,12,52
air_c759b6abeb552160,hpg_e6d06810b701ab12,2016-04-01,5,5,6,10
air_c759b6abeb552160,hpg_e6d06810b701ab12,2016-04-20,15,15,16,30
air_c759b6abeb552160,hpg_e6d06810b701ab12,2016-04-22,19,12,3,31
air_c759b6abeb552160,hpg_e6d06810b701ab12,2016-05-03,11,2,18,13
air_c759b6abeb552160,hpg_e6d06810b701ab12,2016-10-28,8,8,23,16
air_c759b6abeb552160,hpg_e6d06810b701ab12,2016-11-25,9,9,5,18
air_c759b6abeb552160,hpg_e6d06810b701ab12,2016-12-09,38,41,2,79
air_c759b6abeb552160,hpg_e6d06810b701ab12,2016-12-10,44,27,36,71
air_c759b6abeb552160,hpg_e6d06810b701ab12,2016-12-16,13,13,8,26
air_c759b6abeb552160,hpg_e6d06810b701ab12,2016-12-17,61,30,13,91
air_c759b6abeb552160,hpg_e6d06810b701ab12,2016-12-23,4,4,36,8
air_c759b6abeb552160,hpg_e6d06810b701ab12,2016-12-27,25,25,25,50
air_c759b6abeb552160,hpg_e6d06810b701ab12,2017-01-08,3,3,14,6
air_c759b6abeb552160,hpg_e6d06810b701ab12,2017-01-14,11,4,5,15
air_c759b6abeb552160,hpg_e6d06810b701ab12,2017-01-28,17,8,13,25
air_c759b6abeb552160,hpg_e6d06810b701ab12,2017-02-08,17,17,24,34
air_c759b6abeb552160,hpg_e6d06810b701ab12,2017-02-17,14,14,19,28
air_c759b6abeb552160,hpg_e6d06810b701ab12,2017-03-10,10,10,13,20
air_c759b6abeb552160,hpg_e6d06810b701ab12,2017-03-17,40,38,7,78
air_c759b6abeb552160,hpg_e6d06810b701ab12,2017-03-19,30,38,57,68
air_c759b6abeb552160,hpg_e6d06810b701ab12,2017-03-24,35,35,4,70
air_c759b6abeb552160,hpg_e6d06810b701ab12,2017-03-25,12,12,51,24
air_c759b6abeb552160,hpg_e6d06810b701ab12,2017-03-31,4,4,4,8
air_96743eee94114261,hpg_a9d42bc9b56916f4,2016-01-13,14,4,24,18
air_96743eee94114261,hpg_a9d42bc9b56916f4,2016-01-22,10,3,19,13
air_96743eee94114261,hpg_a9d42bc9b56916f4,2016-01-23,24,5,24,29
air_96743eee94114261,hpg_a9d42bc9b56916f4,2016-01-27,16,2,17,18
air_96743eee94114261,hpg_a9d42bc9b56916f4,2016-01-28,6,2,14,8
air_96743eee94114261,hpg_a9d42bc9b56916f4,2016-02-08,4,2,19,6
air_96743eee94114261,hpg_a9d42bc9b56916f4,2016-02-10,10,2,15,12
air_96743eee94114261,hpg_a9d42bc9b56916f4,2016-02-13,24,4,28,28
air_96743eee94114261,hpg_a9d42bc9b56916f4,2016-02-22,5,3,5,8
air_96743eee94114261,hpg_a9d42bc9b56916f4,2016-02-23,10,3,14,13
air_96743eee94114261,hpg_a9d42bc9b56916f4,2016-02-24,7,2,7,9
air_96743eee94114261,hpg_a9d42bc9b56916f4,2016-02-27,29,4,31,33
air_96743eee94114261,hpg_a9d42bc9b56916f4,2016-03-02,7,4,9,11
air_96743eee94114261,hpg_a9d42bc9b56916f4,2016-03-05,9,6,22,15
air_96743eee94114261,hpg_a9d42bc9b56916f4,2016-03-12,30,14,32,44
air_96743eee94114261,hpg_a9d42bc9b56916f4,2016-03-14,20,2,20,22
air_96743eee94114261,hpg_a9d42bc9b56916f4,2016-03-15,3,3,19,6
air_96743eee94114261,hpg_a9d42bc9b56916f4,2016-03-18,17,16,25,33
air_96743eee94114261,hpg_a9d42bc9b56916f4,2016-03-19,21,10,23,31
air_96743eee94114261,hpg_a9d42bc9b56916f4,2016-03-23,10,3,14,13
air_96743eee94114261,hpg_a9d42bc9b56916f4,2016-03-25,9,2,17,11
air_96743eee94114261,hpg_a9d42bc9b56916f4,2016-03-26,26,3,32,29
air_96743eee94114261,hpg_a9d42bc9b56916f4,2016-04-02,18,6,19,24
air_96743eee94114261,hpg_a9d42bc9b56916f4,2016-04-09,13,2,34,15
air_96743eee94114261,hpg_a9d42bc9b56916f4,2016-04-11,15,2,18,17
air_96743eee94114261,hpg_a9d42bc9b56916f4,2016-04-12,12,5,21,17
air_96743eee94114261,hpg_a9d42bc9b56916f4,2016-04-15,11,8,13,19
air_96743eee94114261,hpg_a9d42bc9b56916f4,2016-04-16,18,8,30,26
air_96743eee94114261,hpg_a9d42bc9b56916f4,2016-04-22,14,4,17,18
air_96743eee94114261,hpg_a9d42bc9b56916f4,2016-05-02,21,3,25,24
air_96743eee94114261,hpg_a9d42bc9b56916f4,2016-05-03,10,6,35,16
air_96743eee94114261,hpg_a9d42bc9b56916f4,2016-05-04,17,7,26,24
air_96743eee94114261,hpg_a9d42bc9b56916f4,2016-05-06,11,3,15,14
air_96743eee94114261,hpg_a9d42bc9b56916f4,2016-05-14,19,7,26,26
air_96743eee94114261,hpg_a9d42bc9b56916f4,2016-05-16,7,4,9,11
air_96743eee94114261,hpg_a9d42bc9b56916f4,2016-10-28,26,6,30,32
air_96743eee94114261,hpg_a9d42bc9b56916f4,2016-10-29,16,6,16,22
air_96743eee94114261,hpg_a9d42bc9b56916f4,2016-11-02,8,2,14,10
air_96743eee94114261,hpg_a9d42bc9b56916f4,2016-11-04,10,2,14,12
air_96743eee94114261,hpg_a9d42bc9b56916f4,2016-11-05,20,7,28,27
air_96743eee94114261,hpg_a9d42bc9b56916f4,2016-11-08,26,4,26,30
air_96743eee94114261,hpg_a9d42bc9b56916f4,2016-11-09,4,4,6,8
air_96743eee94114261,hpg_a9d42bc9b56916f4,2016-11-11,9,5,21,14
air_96743eee94114261,hpg_a9d42bc9b56916f4,2016-11-12,20,6,23,26
air_96743eee94114261,hpg_a9d42bc9b56916f4,2016-11-15,14,4,19,18
air_96743eee94114261,hpg_a9d42bc9b56916f4,2016-11-17,18,2,18,20
air_96743eee94114261,hpg_a9d42bc9b56916f4,2016-11-18,11,3,15,14
air_96743eee94114261,hpg_a9d42bc9b56916f4,2016-11-19,14,2,28,16
air_96743eee94114261,hpg_a9d42bc9b56916f4,2016-11-21,17,2,18,19
air_96743eee94114261,hpg_a9d42bc9b56916f4,2016-11-22,7,2,21,9
air_96743eee94114261,hpg_a9d42bc9b56916f4,2016-11-25,11,2,14,13
air_96743eee94114261,hpg_a9d42bc9b56916f4,2016-11-26,24,7,26,31
air_96743eee94114261,hpg_a9d42bc9b56916f4,2016-11-28,12,6,14,18
air_96743eee94114261,hpg_a9d42bc9b56916f4,2016-11-29,21,13,25,34
air_96743eee94114261,hpg_a9d42bc9b56916f4,2016-11-30,12,2,13,14
air_96743eee94114261,hpg_a9d42bc9b56916f4,2016-12-02,30,6,31,36
air_96743eee94114261,hpg_a9d42bc9b56916f4,2016-12-03,28,8,32,36
air_96743eee94114261,hpg_a9d42bc9b56916f4,2016-12-08,2,3,3,5
air_96743eee94114261,hpg_a9d42bc9b56916f4,2016-12-09,13,5,23,18
air_96743eee94114261,hpg_a9d42bc9b56916f4,2016-12-10,25,8,27,33
air_96743eee94114261,hpg_a9d42bc9b56916f4,2016-12-13,13,5,13,18
air_96743eee94114261,hpg_a9d42bc9b56916f4,2016-12-14,12,2,15,14
air_96743eee94114261,hpg_a9d42bc9b56916f4,2016-12-15,11,2,14,13
air_96743eee94114261,hpg_a9d42bc9b56916f4,2016-12-16,25,18,29,43
air_96743eee94114261,hpg_a9d42bc9b56916f4,2016-12-17,23,21,27,44
air_96743eee94114261,hpg_a9d42bc9b56916f4,2016-12-19,14,2,18,16
air_96743eee94114261,hpg_a9d42bc9b56916f4,2016-12-21,22,14,34,36
air_96743eee94114261,hpg_a9d42bc9b56916f4,2016-12-22,24,5,31,29
air_96743eee94114261,hpg_a9d42bc9b56916f4,2016-12-23,21,3,22,24
air_96743eee94114261,hpg_a9d42bc9b56916f4,2016-12-24,18,4,24,22
air_96743eee94114261,hpg_a9d42bc9b56916f4,2016-12-27,28,10,30,38
air_96743eee94114261,hpg_a9d42bc9b56916f4,2016-12-28,25,14,28,39
air_96743eee94114261,hpg_a9d42bc9b56916f4,2016-12-29,30,7,35,37
air_96743eee94114261,hpg_a9d42bc9b56916f4,2016-12-30,21,10,37,31
air_96743eee94114261,hpg_a9d42bc9b56916f4,2017-01-05,8,6,10,14
air_96743eee94114261,hpg_a9d42bc9b56916f4,2017-01-07,21,12,22,33
air_96743eee94114261,hpg_a9d42bc9b56916f4,2017-01-08,7,2,14,9
air_96743eee94114261,hpg_a9d42bc9b56916f4,2017-01-10,5,3,9,8
air_96743eee94114261,hpg_a9d42bc9b56916f4,2017-01-12,9,2,13,11
air_96743eee94114261,hpg_a9d42bc9b56916f4,2017-01-13,19,12,21,31
air_96743eee94114261,hpg_a9d42bc9b56916f4,2017-01-14,11,5,13,16
air_96743eee94114261,hpg_a9d42bc9b56916f4,2017-01-16,3,5,15,8
air_96743eee94114261,hpg_a9d42bc9b56916f4,2017-01-17,2,2,4,4
air_96743eee94114261,hpg_a9d42bc9b56916f4,2017-01-18,11,4,18,15
air_96743eee94114261,hpg_a9d42bc9b56916f4,2017-01-20,28,13,50,41
air_96743eee94114261,hpg_a9d42bc9b56916f4,2017-01-21,23,2,32,25
air_96743eee94114261,hpg_a9d42bc9b56916f4,2017-01-23,10,2,14,12
air_96743eee94114261,hpg_a9d42bc9b56916f4,2017-01-24,5,2,8,7
air_96743eee94114261,hpg_a9d42bc9b56916f4,2017-01-25,4,4,11,8
air_96743eee94114261,hpg_a9d42bc9b56916f4,2017-01-27,14,13,27,27
air_96743eee94114261,hpg_a9d42bc9b56916f4,2017-01-28,25,8,31,33
air_96743eee94114261,hpg_a9d42bc9b56916f4,2017-01-31,10,7,12,17
air_96743eee94114261,hpg_a9d42bc9b56916f4,2017-02-02,15,2,21,17
air_96743eee94114261,hpg_a9d42bc9b56916f4,2017-02-03,10,2,18,12
air_96743eee94114261,hpg_a9d42bc9b56916f4,2017-02-04,28,12,28,40
air_96743eee94114261,hpg_a9d42bc9b56916f4,2017-02-08,2,2,4,4
air_96743eee94114261,hpg_a9d42bc9b56916f4,2017-02-10,17,7,22,24
air_96743eee94114261,hpg_a9d42bc9b56916f4,2017-02-11,19,10,25,29
air_96743eee94114261,hpg_a9d42bc9b56916f4,2017-02-13,14,2,21,16
air_96743eee94114261,hpg_a9d42bc9b56916f4,2017-02-16,13,2,16,15
air_96743eee94114261,hpg_a9d42bc9b56916f4,2017-02-17,18,6,21,24
air_96743eee94114261,hpg_a9d42bc9b56916f4,2017-02-18,4,2,6,6
air_96743eee94114261,hpg_a9d42bc9b56916f4,2017-02-23,17,5,26,22
air_96743eee94114261,hpg_a9d42bc9b56916f4,2017-02-24,16,2,20,18
air_96743eee94114261,hpg_a9d42bc9b56916f4,2017-02-25,17,34,20,51
air_96743eee94114261,hpg_a9d42bc9b56916f4,2017-02-28,10,2,20,12
air_96743eee94114261,hpg_a9d42bc9b56916f4,2017-03-01,9,1,9,10
air_96743eee94114261,hpg_a9d42bc9b56916f4,2017-03-03,18,9,27,27
air_96743eee94114261,hpg_a9d42bc9b56916f4,2017-03-04,23,4,34,27
air_96743eee94114261,hpg_a9d42bc9b56916f4,2017-03-07,19,4,20,23
air_96743eee94114261,hpg_a9d42bc9b56916f4,2017-03-08,17,2,22,19
air_96743eee94114261,hpg_a9d42bc9b56916f4,2017-03-10,24,11,28,35
air_96743eee94114261,hpg_a9d42bc9b56916f4,2017-03-11,25,11,28,36
air_96743eee94114261,hpg_a9d42bc9b56916f4,2017-03-16,12,4,19,16
air_96743eee94114261,hpg_a9d42bc9b56916f4,2017-03-17,24,2,28,26
air_96743eee94114261,hpg_a9d42bc9b56916f4,2017-03-18,28,14,28,42
air_96743eee94114261,hpg_a9d42bc9b56916f4,2017-03-19,8,2,19,10
air_96743eee94114261,hpg_a9d42bc9b56916f4,2017-03-21,24,7,30,31
air_96743eee94114261,hpg_a9d42bc9b56916f4,2017-03-23,12,4,17,16
air_96743eee94114261,hpg_a9d42bc9b56916f4,2017-03-24,24,8,47,32
air_96743eee94114261,hpg_a9d42bc9b56916f4,2017-03-25,24,8,25,32
air_96743eee94114261,hpg_a9d42bc9b56916f4,2017-03-27,15,2,15,17
air_96743eee94114261,hpg_a9d42bc9b56916f4,2017-03-28,9,2,12,11
air_96743eee94114261,hpg_a9d42bc9b56916f4,2017-03-29,24,24,24,48
air_96743eee94114261,hpg_a9d42bc9b56916f4,2017-03-31,27,1,28,28
air_96743eee94114261,hpg_a9d42bc9b56916f4,2017-04-05,10,29,14,39
air_96743eee94114261,hpg_a9d42bc9b56916f4,2017-04-07,7,3,14,10
air_96743eee94114261,hpg_a9d42bc9b56916f4,2017-04-08,19,5,21,24
air_96743eee94114261,hpg_a9d42bc9b56916f4,2017-04-10,12,2,14,14
air_96743eee94114261,hpg_a9d42bc9b56916f4,2017-04-12,2,2,5,4
air_96743eee94114261,hpg_a9d42bc9b56916f4,2017-04-13,4,4,7,8
air_96743eee94114261,hpg_a9d42bc9b56916f4,2017-04-20,7,3,14,10
air_96743eee94114261,hpg_a9d42bc9b56916f4,2017-04-21,22,16,31,38
air_96743eee94114261,hpg_a9d42bc9b56916f4,2017-04-22,9,2,21,11
air_707d4b6328f2c2df,hpg_7acec6bb6ec9d98e,2017-01-07,76,2,76,78
air_707d4b6328f2c2df,hpg_7acec6bb6ec9d98e,2017-01-20,25,11,40,36
air_707d4b6328f2c2df,hpg_7acec6bb6ec9d98e,2017-01-21,20,8,38,28
air_707d4b6328f2c2df,hpg_7acec6bb6ec9d98e,2017-01-24,3,3,10,6
air_707d4b6328f2c2df,hpg_7acec6bb6ec9d98e,2017-02-16,18,8,15,26
air_707d4b6328f2c2df,hpg_7acec6bb6ec9d98e,2017-02-21,25,4,39,29
air_707d4b6328f2c2df,hpg_7acec6bb6ec9d98e,2017-02-26,10,7,22,17
air_707d4b6328f2c2df,hpg_7acec6bb6ec9d98e,2017-02-27,3,3,6,6
air_707d4b6328f2c2df,hpg_7acec6bb6ec9d98e,2017-03-09,9,5,16,14
air_707d4b6328f2c2df,hpg_7acec6bb6ec9d98e,2017-03-10,41,35,47,76
air_707d4b6328f2c2df,hpg_7acec6bb6ec9d98e,2017-03-17,9,40,30,49
air_707d4b6328f2c2df,hpg_7acec6bb6ec9d98e,2017-03-31,51,25,74,76
air_707d4b6328f2c2df,hpg_7acec6bb6ec9d98e,2017-04-12,25,30,25,55
air_707d4b6328f2c2df,hpg_7acec6bb6ec9d98e,2017-04-14,7,30,27,37
air_707d4b6328f2c2df,hpg_7acec6bb6ec9d98e,2017-04-21,11,16,68,27
air_622375b4815cf5cb,hpg_ab64d4038f396dc3,2016-01-16,22,7,45,29
air_622375b4815cf5cb,hpg_ab64d4038f396dc3,2016-01-20,3,3,15,6
air_622375b4815cf5cb,hpg_ab64d4038f396dc3,2016-01-22,2,2,79,4
air_622375b4815cf5cb,hpg_ab64d4038f396dc3,2016-01-23,31,3,42,34
air_622375b4815cf5cb,hpg_ab64d4038f396dc3,2016-01-29,9,2,19,11
air_622375b4815cf5cb,hpg_ab64d4038f396dc3,2016-01-30,86,7,90,93
air_622375b4815cf5cb,hpg_ab64d4038f396dc3,2016-02-04,2,5,8,7
air_622375b4815cf5cb,hpg_ab64d4038f396dc3,2016-02-06,15,4,34,19
air_622375b4815cf5cb,hpg_ab64d4038f396dc3,2016-02-10,38,38,54,76
air_622375b4815cf5cb,hpg_ab64d4038f396dc3,2016-02-12,9,5,11,14
air_622375b4815cf5cb,hpg_ab64d4038f396dc3,2016-02-13,57,2,59,59
air_622375b4815cf5cb,hpg_ab64d4038f396dc3,2016-02-26,4,4,16,8
air_622375b4815cf5cb,hpg_ab64d4038f396dc3,2016-02-27,32,5,50,37
air_622375b4815cf5cb,hpg_ab64d4038f396dc3,2016-03-05,92,4,91,96
air_622375b4815cf5cb,hpg_ab64d4038f396dc3,2016-03-09,29,2,28,31
air_622375b4815cf5cb,hpg_ab64d4038f396dc3,2016-03-16,19,14,23,33
air_622375b4815cf5cb,hpg_ab64d4038f396dc3,2016-03-25,89,12,105,101
air_622375b4815cf5cb,hpg_ab64d4038f396dc3,2016-03-26,80,4,64,84
air_622375b4815cf5cb,hpg_ab64d4038f396dc3,2016-04-01,21,4,24,25
air_622375b4815cf5cb,hpg_ab64d4038f396dc3,2016-04-09,47,7,70,54
air_622375b4815cf5cb,hpg_ab64d4038f396dc3,2016-04-16,49,30,64,79
air_622375b4815cf5cb,hpg_ab64d4038f396dc3,2017-01-17,2,2,14,4
air_622375b4815cf5cb,hpg_ab64d4038f396dc3,2017-02-24,2,2,35,4
air_622375b4815cf5cb,hpg_ab64d4038f396dc3,2017-03-02,5,5,25,10
air_622375b4815cf5cb,hpg_ab64d4038f396dc3,2017-03-04,4,6,26,10
air_622375b4815cf5cb,hpg_ab64d4038f396dc3,2017-03-07,2,2,4,4
air_622375b4815cf5cb,hpg_ab64d4038f396dc3,2017-03-10,67,15,71,82
air_622375b4815cf5cb,hpg_ab64d4038f396dc3,2017-03-11,65,7,86,72
air_622375b4815cf5cb,hpg_ab64d4038f396dc3,2017-03-17,69,19,69,88
air_622375b4815cf5cb,hpg_ab64d4038f396dc3,2017-03-19,23,5,25,28
air_622375b4815cf5cb,hpg_ab64d4038f396dc3,2017-03-21,4,4,17,8
air_622375b4815cf5cb,hpg_ab64d4038f396dc3,2017-03-23,14,9,22,23
air_622375b4815cf5cb,hpg_ab64d4038f396dc3,2017-03-24,39,4,71,43
air_622375b4815cf5cb,hpg_ab64d4038f396dc3,2017-03-25,39,2,63,41
air_622375b4815cf5cb,hpg_ab64d4038f396dc3,2017-03-28,15,11,24,26
air_622375b4815cf5cb,hpg_ab64d4038f396dc3,2017-03-30,17,7,24,24
air_622375b4815cf5cb,hpg_ab64d4038f396dc3,2017-03-31,24,12,44,36
air_622375b4815cf5cb,hpg_ab64d4038f396dc3,2017-04-01,31,11,48,42
air_622375b4815cf5cb,hpg_ab64d4038f396dc3,2017-04-04,13,13,22,26
air_622375b4815cf5cb,hpg_ab64d4038f396dc3,2017-04-05,7,2,17,9
air_622375b4815cf5cb,hpg_ab64d4038f396dc3,2017-04-07,55,3,71,58
air_622375b4815cf5cb,hpg_ab64d4038f396dc3,2017-04-14,29,40,98,69
air_622375b4815cf5cb,hpg_ab64d4038f396dc3,2017-04-15,24,9,30,33
air_622375b4815cf5cb,hpg_ab64d4038f396dc3,2017-04-21,22,6,39,28
air_622375b4815cf5cb,hpg_ab64d4038f396dc3,2017-04-22,45,21,51,66
air_cbe867adcf44e14f,hpg_0183ec352e38903c,2017-03-04,34,5,56,39
air_cbe867adcf44e14f,hpg_0183ec352e38903c,2017-03-10,10,4,40,14
air_cbe867adcf44e14f,hpg_0183ec352e38903c,2017-03-11,28,3,32,31
air_cbe867adcf44e14f,hpg_0183ec352e38903c,2017-03-17,41,7,68,48
air_cbe867adcf44e14f,hpg_0183ec352e38903c,2017-03-18,13,3,22,16
air_cbe867adcf44e14f,hpg_0183ec352e38903c,2017-03-19,3,7,29,10
air_cbe867adcf44e14f,hpg_0183ec352e38903c,2017-03-24,24,3,34,27
air_cbe867adcf44e14f,hpg_0183ec352e38903c,2017-03-25,36,6,38,42
air_cbe867adcf44e14f,hpg_0183ec352e38903c,2017-04-11,2,2,2,4
air_cbe867adcf44e14f,hpg_0183ec352e38903c,2017-04-14,20,6,30,26
air_cbe867adcf44e14f,hpg_0183ec352e38903c,2017-04-20,6,6,12,12
air_2cee51fa6fdf6c0d,hpg_113fd6e4fa77800f,2016-01-05,2,2,2,4
air_2cee51fa6fdf6c0d,hpg_113fd6e4fa77800f,2016-01-19,2,4,7,6
air_2cee51fa6fdf6c0d,hpg_113fd6e4fa77800f,2016-01-21,9,2,13,11
air_2cee51fa6fdf6c0d,hpg_113fd6e4fa77800f,2016-02-01,6,4,11,10
air_2cee51fa6fdf6c0d,hpg_113fd6e4fa77800f,2016-02-04,4,2,2,6
air_2cee51fa6fdf6c0d,hpg_113fd6e4fa77800f,2016-02-08,11,4,13,15
air_2cee51fa6fdf6c0d,hpg_113fd6e4fa77800f,2016-02-09,13,2,14,15
air_2cee51fa6fdf6c0d,hpg_113fd6e4fa77800f,2016-02-16,2,2,6,4
air_2cee51fa6fdf6c0d,hpg_113fd6e4fa77800f,2016-02-22,9,2,12,11
air_2cee51fa6fdf6c0d,hpg_113fd6e4fa77800f,2016-02-23,6,2,10,8
air_2cee51fa6fdf6c0d,hpg_113fd6e4fa77800f,2016-02-25,12,5,17,17
air_2cee51fa6fdf6c0d,hpg_113fd6e4fa77800f,2016-02-29,13,4,15,17
air_2cee51fa6fdf6c0d,hpg_113fd6e4fa77800f,2016-03-01,12,2,14,14
air_2cee51fa6fdf6c0d,hpg_113fd6e4fa77800f,2016-03-03,18,2,23,20
air_2cee51fa6fdf6c0d,hpg_113fd6e4fa77800f,2016-03-07,2,2,12,4
air_2cee51fa6fdf6c0d,hpg_113fd6e4fa77800f,2016-03-14,12,2,20,14
air_2cee51fa6fdf6c0d,hpg_113fd6e4fa77800f,2016-03-15,8,2,9,10
air_2cee51fa6fdf6c0d,hpg_113fd6e4fa77800f,2016-03-17,3,5,11,8
air_2cee51fa6fdf6c0d,hpg_113fd6e4fa77800f,2016-03-24,4,5,7,9
air_2cee51fa6fdf6c0d,hpg_113fd6e4fa77800f,2016-04-05,11,3,12,14
air_2cee51fa6fdf6c0d,hpg_113fd6e4fa77800f,2016-04-11,6,4,6,10
air_2cee51fa6fdf6c0d,hpg_113fd6e4fa77800f,2016-04-12,8,2,10,10
air_2cee51fa6fdf6c0d,hpg_113fd6e4fa77800f,2016-04-18,4,4,8,8
air_2cee51fa6fdf6c0d,hpg_113fd6e4fa77800f,2016-04-26,6,4,14,10
air_2cee51fa6fdf6c0d,hpg_113fd6e4fa77800f,2016-05-12,2,2,6,4
air_2cee51fa6fdf6c0d,hpg_113fd6e4fa77800f,2016-05-17,2,2,10,4
air_2cee51fa6fdf6c0d,hpg_113fd6e4fa77800f,2016-06-02,4,4,5,8
air_2cee51fa6fdf6c0d,hpg_113fd6e4fa77800f,2016-06-06,2,2,7,4
air_2cee51fa6fdf6c0d,hpg_113fd6e4fa77800f,2016-10-27,16,7,31,23
air_2cee51fa6fdf6c0d,hpg_113fd6e4fa77800f,2016-10-28,13,4,7,17
air_2cee51fa6fdf6c0d,hpg_113fd6e4fa77800f,2016-10-29,17,6,50,23
air_2cee51fa6fdf6c0d,hpg_113fd6e4fa77800f,2016-10-31,7,7,12,14
air_2cee51fa6fdf6c0d,hpg_113fd6e4fa77800f,2016-11-03,16,8,22,24
air_2cee51fa6fdf6c0d,hpg_113fd6e4fa77800f,2016-11-04,7,3,12,10
air_2cee51fa6fdf6c0d,hpg_113fd6e4fa77800f,2016-11-05,13,8,33,21
air_2cee51fa6fdf6c0d,hpg_113fd6e4fa77800f,2016-11-07,18,2,19,20
air_2cee51fa6fdf6c0d,hpg_113fd6e4fa77800f,2016-11-08,2,2,8,4
air_2cee51fa6fdf6c0d,hpg_113fd6e4fa77800f,2016-11-10,7,4,11,11
air_2cee51fa6fdf6c0d,hpg_113fd6e4fa77800f,2016-11-11,9,4,10,13
air_2cee51fa6fdf6c0d,hpg_113fd6e4fa77800f,2016-11-12,21,5,41,26
air_2cee51fa6fdf6c0d,hpg_113fd6e4fa77800f,2016-11-13,10,7,21,17
air_2cee51fa6fdf6c0d,hpg_113fd6e4fa77800f,2016-11-14,8,6,16,14
air_2cee51fa6fdf6c0d,hpg_113fd6e4fa77800f,2016-11-15,4,4,11,8
air_2cee51fa6fdf6c0d,hpg_113fd6e4fa77800f,2016-11-17,4,6,10,10
air_2cee51fa6fdf6c0d,hpg_113fd6e4fa77800f,2016-11-18,9,5,12,14
air_2cee51fa6fdf6c0d,hpg_113fd6e4fa77800f,2016-11-19,21,4,41,25
air_2cee51fa6fdf6c0d,hpg_113fd6e4fa77800f,2016-11-21,2,2,8,4
air_2cee51fa6fdf6c0d,hpg_113fd6e4fa77800f,2016-11-22,3,2,17,5
air_2cee51fa6fdf6c0d,hpg_113fd6e4fa77800f,2016-11-24,13,4,13,17
air_2cee51fa6fdf6c0d,hpg_113fd6e4fa77800f,2016-11-26,6,2,14,8
air_2cee51fa6fdf6c0d,hpg_113fd6e4fa77800f,2016-11-27,22,2,47,24
air_2cee51fa6fdf6c0d,hpg_113fd6e4fa77800f,2016-11-28,13,6,22,19
air_2cee51fa6fdf6c0d,hpg_113fd6e4fa77800f,2016-11-29,9,7,15,16
air_2cee51fa6fdf6c0d,hpg_113fd6e4fa77800f,2016-12-02,10,4,12,14
air_2cee51fa6fdf6c0d,hpg_113fd6e4fa77800f,2016-12-03,6,2,25,8
air_2cee51fa6fdf6c0d,hpg_113fd6e4fa77800f,2016-12-04,14,6,40,20
air_2cee51fa6fdf6c0d,hpg_113fd6e4fa77800f,2016-12-06,2,2,1,4
air_2cee51fa6fdf6c0d,hpg_113fd6e4fa77800f,2016-12-08,14,12,22,26
air_2cee51fa6fdf6c0d,hpg_113fd6e4fa77800f,2016-12-09,6,11,23,17
air_2cee51fa6fdf6c0d,hpg_113fd6e4fa77800f,2016-12-10,27,29,37,56
air_2cee51fa6fdf6c0d,hpg_113fd6e4fa77800f,2016-12-11,16,4,35,20
air_2cee51fa6fdf6c0d,hpg_113fd6e4fa77800f,2016-12-12,6,2,15,8
air_2cee51fa6fdf6c0d,hpg_113fd6e4fa77800f,2016-12-16,11,2,22,13
air_2cee51fa6fdf6c0d,hpg_113fd6e4fa77800f,2016-12-17,31,22,50,53
air_2cee51fa6fdf6c0d,hpg_113fd6e4fa77800f,2016-12-18,37,25,62,62
air_2cee51fa6fdf6c0d,hpg_113fd6e4fa77800f,2016-12-20,10,2,21,12
air_2cee51fa6fdf6c0d,hpg_113fd6e4fa77800f,2016-12-22,11,7,25,18
air_2cee51fa6fdf6c0d,hpg_113fd6e4fa77800f,2016-12-23,22,43,29,65
air_2cee51fa6fdf6c0d,hpg_113fd6e4fa77800f,2016-12-24,33,55,43,88
air_2cee51fa6fdf6c0d,hpg_113fd6e4fa77800f,2016-12-25,20,27,22,47
air_2cee51fa6fdf6c0d,hpg_113fd6e4fa77800f,2016-12-26,6,2,9,8
air_2cee51fa6fdf6c0d,hpg_113fd6e4fa77800f,2017-01-05,18,6,18,24
air_2cee51fa6fdf6c0d,hpg_113fd6e4fa77800f,2017-01-08,18,4,39,22
air_2cee51fa6fdf6c0d,hpg_113fd6e4fa77800f,2017-01-10,6,4,12,10
air_2cee51fa6fdf6c0d,hpg_113fd6e4fa77800f,2017-01-12,4,4,4,8
air_2cee51fa6fdf6c0d,hpg_113fd6e4fa77800f,2017-01-14,12,3,45,15
air_2cee51fa6fdf6c0d,hpg_113fd6e4fa77800f,2017-01-15,5,3,30,8
air_2cee51fa6fdf6c0d,hpg_113fd6e4fa77800f,2017-01-19,5,5,22,10
air_2cee51fa6fdf6c0d,hpg_113fd6e4fa77800f,2017-01-20,20,5,22,25
air_2cee51fa6fdf6c0d,hpg_113fd6e4fa77800f,2017-01-21,16,12,39,28
air_2cee51fa6fdf6c0d,hpg_113fd6e4fa77800f,2017-01-22,22,2,37,24
air_2cee51fa6fdf6c0d,hpg_113fd6e4fa77800f,2017-01-23,2,2,12,4
air_2cee51fa6fdf6c0d,hpg_113fd6e4fa77800f,2017-01-26,7,6,14,13
air_2cee51fa6fdf6c0d,hpg_113fd6e4fa77800f,2017-01-27,8,5,18,13
air_2cee51fa6fdf6c0d,hpg_113fd6e4fa77800f,2017-01-28,16,11,20,27
air_2cee51fa6fdf6c0d,hpg_113fd6e4fa77800f,2017-01-29,11,4,21,15
air_2cee51fa6fdf6c0d,hpg_113fd6e4fa77800f,2017-01-30,4,2,11,6
air_2cee51fa6fdf6c0d,hpg_113fd6e4fa77800f,2017-02-02,4,4,8,8
air_2cee51fa6fdf6c0d,hpg_113fd6e4fa77800f,2017-02-03,4,2,11,6
air_2cee51fa6fdf6c0d,hpg_113fd6e4fa77800f,2017-02-04,22,9,35,31
air_2cee51fa6fdf6c0d,hpg_113fd6e4fa77800f,2017-02-05,27,12,31,39
air_2cee51fa6fdf6c0d,hpg_113fd6e4fa77800f,2017-02-06,2,2,8,4
air_2cee51fa6fdf6c0d,hpg_113fd6e4fa77800f,2017-02-07,4,4,5,8
air_2cee51fa6fdf6c0d,hpg_113fd6e4fa77800f,2017-02-10,12,15,19,27
air_2cee51fa6fdf6c0d,hpg_113fd6e4fa77800f,2017-02-11,24,12,39,36
air_2cee51fa6fdf6c0d,hpg_113fd6e4fa77800f,2017-02-12,17,8,20,25
air_2cee51fa6fdf6c0d,hpg_113fd6e4fa77800f,2017-02-14,2,6,12,8
air_2cee51fa6fdf6c0d,hpg_113fd6e4fa77800f,2017-02-16,2,4,3,6
air_2cee51fa6fdf6c0d,hpg_113fd6e4fa77800f,2017-02-17,17,15,23,32
air_2cee51fa6fdf6c0d,hpg_113fd6e4fa77800f,2017-02-18,9,3,25,12
air_2cee51fa6fdf6c0d,hpg_113fd6e4fa77800f,2017-02-19,20,10,39,30
air_2cee51fa6fdf6c0d,hpg_113fd6e4fa77800f,2017-02-23,2,2,10,4
air_2cee51fa6fdf6c0d,hpg_113fd6e4fa77800f,2017-02-24,3,13,22,16
air_2cee51fa6fdf6c0d,hpg_113fd6e4fa77800f,2017-02-25,39,9,45,48
air_2cee51fa6fdf6c0d,hpg_113fd6e4fa77800f,2017-02-26,8,4,30,12
air_2cee51fa6fdf6c0d,hpg_113fd6e4fa77800f,2017-02-27,11,4,13,15
air_2cee51fa6fdf6c0d,hpg_113fd6e4fa77800f,2017-02-28,5,5,7,10
air_2cee51fa6fdf6c0d,hpg_113fd6e4fa77800f,2017-03-02,2,2,10,4
air_2cee51fa6fdf6c0d,hpg_113fd6e4fa77800f,2017-03-03,14,6,23,20
air_2cee51fa6fdf6c0d,hpg_113fd6e4fa77800f,2017-03-04,30,30,45,60
air_2cee51fa6fdf6c0d,hpg_113fd6e4fa77800f,2017-03-05,22,2,36,24
air_2cee51fa6fdf6c0d,hpg_113fd6e4fa77800f,2017-03-06,7,3,7,10
air_2cee51fa6fdf6c0d,hpg_113fd6e4fa77800f,2017-03-07,6,6,13,12
air_2cee51fa6fdf6c0d,hpg_113fd6e4fa77800f,2017-03-10,9,4,17,13
air_2cee51fa6fdf6c0d,hpg_113fd6e4fa77800f,2017-03-11,14,6,44,20
air_2cee51fa6fdf6c0d,hpg_113fd6e4fa77800f,2017-03-12,7,4,51,11
air_2cee51fa6fdf6c0d,hpg_113fd6e4fa77800f,2017-03-13,6,4,12,10
air_2cee51fa6fdf6c0d,hpg_113fd6e4fa77800f,2017-03-14,7,2,12,9
air_2cee51fa6fdf6c0d,hpg_113fd6e4fa77800f,2017-03-16,7,7,13,14
air_2cee51fa6fdf6c0d,hpg_113fd6e4fa77800f,2017-03-17,4,2,14,6
air_2cee51fa6fdf6c0d,hpg_113fd6e4fa77800f,2017-03-18,12,11,46,23
air_2cee51fa6fdf6c0d,hpg_113fd6e4fa77800f,2017-03-19,18,12,47,30
air_2cee51fa6fdf6c0d,hpg_113fd6e4fa77800f,2017-03-20,27,16,40,43
air_2cee51fa6fdf6c0d,hpg_113fd6e4fa77800f,2017-03-23,14,20,16,34
air_2cee51fa6fdf6c0d,hpg_113fd6e4fa77800f,2017-03-24,11,9,15,20
air_2cee51fa6fdf6c0d,hpg_113fd6e4fa77800f,2017-03-25,16,19,23,35
air_2cee51fa6fdf6c0d,hpg_113fd6e4fa77800f,2017-03-26,10,2,22,12
air_2cee51fa6fdf6c0d,hpg_113fd6e4fa77800f,2017-03-27,8,6,10,14
air_2cee51fa6fdf6c0d,hpg_113fd6e4fa77800f,2017-03-30,8,6,17,14
air_2cee51fa6fdf6c0d,hpg_113fd6e4fa77800f,2017-03-31,2,5,9,7
air_2cee51fa6fdf6c0d,hpg_113fd6e4fa77800f,2017-04-01,12,2,28,14
air_2cee51fa6fdf6c0d,hpg_113fd6e4fa77800f,2017-04-02,26,21,48,47
air_2cee51fa6fdf6c0d,hpg_113fd6e4fa77800f,2017-04-06,4,2,4,6
air_2cee51fa6fdf6c0d,hpg_113fd6e4fa77800f,2017-04-07,3,2,9,5
air_2cee51fa6fdf6c0d,hpg_113fd6e4fa77800f,2017-04-08,14,4,33,18
air_2cee51fa6fdf6c0d,hpg_113fd6e4fa77800f,2017-04-09,7,4,33,11
air_2cee51fa6fdf6c0d,hpg_113fd6e4fa77800f,2017-04-13,5,5,7,10
air_2cee51fa6fdf6c0d,hpg_113fd6e4fa77800f,2017-04-14,9,2,21,11
air_2cee51fa6fdf6c0d,hpg_113fd6e4fa77800f,2017-04-15,13,3,15,16
air_2cee51fa6fdf6c0d,hpg_113fd6e4fa77800f,2017-04-16,16,10,30,26
air_2cee51fa6fdf6c0d,hpg_113fd6e4fa77800f,2017-04-17,2,2,4,4
air_2cee51fa6fdf6c0d,hpg_113fd6e4fa77800f,2017-04-20,8,5,12,13
air_2cee51fa6fdf6c0d,hpg_113fd6e4fa77800f,2017-04-21,11,8,8,19
air_2cee51fa6fdf6c0d,hpg_113fd6e4fa77800f,2017-04-22,15,5,41,20
air_fcd4492c83f1c6b9,hpg_218a1ea95def8ea3,2016-11-19,9,9,67,18
air_fcd4492c83f1c6b9,hpg_218a1ea95def8ea3,2016-12-03,3,8,32,11
air_fcd4492c83f1c6b9,hpg_218a1ea95def8ea3,2016-12-09,23,10,24,33
air_fcd4492c83f1c6b9,hpg_218a1ea95def8ea3,2016-12-16,26,21,39,47
air_fcd4492c83f1c6b9,hpg_218a1ea95def8ea3,2016-12-17,35,10,45,45
air_fcd4492c83f1c6b9,hpg_218a1ea95def8ea3,2016-12-21,2,10,21,12
air_fcd4492c83f1c6b9,hpg_218a1ea95def8ea3,2016-12-22,24,30,37,54
air_fcd4492c83f1c6b9,hpg_218a1ea95def8ea3,2016-12-23,34,17,41,51
air_fcd4492c83f1c6b9,hpg_218a1ea95def8ea3,2016-12-24,15,14,40,29
air_fcd4492c83f1c6b9,hpg_218a1ea95def8ea3,2016-12-25,19,2,58,21
air_fcd4492c83f1c6b9,hpg_218a1ea95def8ea3,2016-12-27,8,6,28,14
air_fcd4492c83f1c6b9,hpg_218a1ea95def8ea3,2017-01-07,9,13,23,22
air_fcd4492c83f1c6b9,hpg_218a1ea95def8ea3,2017-01-13,9,4,19,13
air_fcd4492c83f1c6b9,hpg_218a1ea95def8ea3,2017-01-21,14,3,31,17
air_fcd4492c83f1c6b9,hpg_218a1ea95def8ea3,2017-01-29,85,8,98,93
air_fcd4492c83f1c6b9,hpg_218a1ea95def8ea3,2017-02-04,23,14,36,37
air_fcd4492c83f1c6b9,hpg_218a1ea95def8ea3,2017-02-05,19,9,65,28
air_fcd4492c83f1c6b9,hpg_218a1ea95def8ea3,2017-02-10,14,2,21,16
air_fcd4492c83f1c6b9,hpg_218a1ea95def8ea3,2017-02-24,9,8,19,17
air_fcd4492c83f1c6b9,hpg_218a1ea95def8ea3,2017-02-25,28,8,49,36
air_fcd4492c83f1c6b9,hpg_218a1ea95def8ea3,2017-03-04,18,6,41,24
air_fcd4492c83f1c6b9,hpg_218a1ea95def8ea3,2017-03-11,31,10,37,41
air_fcd4492c83f1c6b9,hpg_218a1ea95def8ea3,2017-03-14,9,2,32,11
air_fcd4492c83f1c6b9,hpg_218a1ea95def8ea3,2017-03-19,8,17,22,25
air_fcd4492c83f1c6b9,hpg_218a1ea95def8ea3,2017-04-08,12,17,41,29
air_fcd4492c83f1c6b9,hpg_218a1ea95def8ea3,2017-04-18,2,2,24,4
air_55c3627912b9c849,hpg_9d140ea335b9efd4,2016-11-19,4,2,22,6
air_55c3627912b9c849,hpg_9d140ea335b9efd4,2016-11-26,12,5,15,17
air_55c3627912b9c849,hpg_9d140ea335b9efd4,2016-12-02,16,12,19,28
air_55c3627912b9c849,hpg_9d140ea335b9efd4,2016-12-03,18,2,11,20
air_55c3627912b9c849,hpg_9d140ea335b9efd4,2016-12-09,10,8,32,18
air_55c3627912b9c849,hpg_9d140ea335b9efd4,2016-12-10,17,4,22,21
air_55c3627912b9c849,hpg_9d140ea335b9efd4,2016-12-13,17,35,18,52
air_55c3627912b9c849,hpg_9d140ea335b9efd4,2016-12-17,17,5,31,22
air_55c3627912b9c849,hpg_9d140ea335b9efd4,2016-12-19,10,4,12,14
air_55c3627912b9c849,hpg_9d140ea335b9efd4,2016-12-20,9,9,22,18
air_55c3627912b9c849,hpg_9d140ea335b9efd4,2016-12-22,14,18,18,32
air_55c3627912b9c849,hpg_9d140ea335b9efd4,2016-12-23,14,12,26,26
air_55c3627912b9c849,hpg_9d140ea335b9efd4,2016-12-24,25,15,27,40
air_55c3627912b9c849,hpg_9d140ea335b9efd4,2016-12-27,9,3,20,12
air_55c3627912b9c849,hpg_9d140ea335b9efd4,2016-12-28,7,5,15,12
air_55c3627912b9c849,hpg_9d140ea335b9efd4,2016-12-29,16,2,22,18
air_55c3627912b9c849,hpg_9d140ea335b9efd4,2017-01-03,2,2,8,4
air_55c3627912b9c849,hpg_9d140ea335b9efd4,2017-01-06,14,4,27,18
air_55c3627912b9c849,hpg_9d140ea335b9efd4,2017-01-07,13,4,27,17
air_55c3627912b9c849,hpg_9d140ea335b9efd4,2017-01-13,10,2,8,12
air_55c3627912b9c849,hpg_9d140ea335b9efd4,2017-01-14,6,3,13,9
air_55c3627912b9c849,hpg_9d140ea335b9efd4,2017-01-15,4,4,4,8
air_55c3627912b9c849,hpg_9d140ea335b9efd4,2017-01-20,12,2,27,14
air_55c3627912b9c849,hpg_9d140ea335b9efd4,2017-01-24,12,4,9,16
air_55c3627912b9c849,hpg_9d140ea335b9efd4,2017-01-28,13,5,16,18
air_55c3627912b9c849,hpg_9d140ea335b9efd4,2017-01-30,7,2,12,9
air_55c3627912b9c849,hpg_9d140ea335b9efd4,2017-01-31,9,9,10,18
air_55c3627912b9c849,hpg_9d140ea335b9efd4,2017-02-03,4,2,8,6
air_55c3627912b9c849,hpg_9d140ea335b9efd4,2017-02-08,2,2,8,4
air_55c3627912b9c849,hpg_9d140ea335b9efd4,2017-02-18,17,9,29,26
air_55c3627912b9c849,hpg_9d140ea335b9efd4,2017-02-23,10,10,14,20
air_55c3627912b9c849,hpg_9d140ea335b9efd4,2017-02-24,15,15,18,30
air_55c3627912b9c849,hpg_9d140ea335b9efd4,2017-02-25,14,2,21,16
air_55c3627912b9c849,hpg_9d140ea335b9efd4,2017-02-28,9,3,18,12
air_55c3627912b9c849,hpg_9d140ea335b9efd4,2017-03-04,18,2,30,20
air_55c3627912b9c849,hpg_9d140ea335b9efd4,2017-03-06,6,2,14,8
air_55c3627912b9c849,hpg_9d140ea335b9efd4,2017-03-11,11,4,13,15
air_55c3627912b9c849,hpg_9d140ea335b9efd4,2017-03-14,11,4,11,15
air_55c3627912b9c849,hpg_9d140ea335b9efd4,2017-03-15,14,10,23,24
air_55c3627912b9c849,hpg_9d140ea335b9efd4,2017-03-17,3,13,16,16
air_55c3627912b9c849,hpg_9d140ea335b9efd4,2017-03-18,28,5,36,33
air_55c3627912b9c849,hpg_9d140ea335b9efd4,2017-03-22,13,5,11,18
air_55c3627912b9c849,hpg_9d140ea335b9efd4,2017-03-23,4,4,9,8
air_55c3627912b9c849,hpg_9d140ea335b9efd4,2017-03-24,10,2,11,12
air_55c3627912b9c849,hpg_9d140ea335b9efd4,2017-03-25,15,3,25,18
air_55c3627912b9c849,hpg_9d140ea335b9efd4,2017-03-29,4,2,9,6
air_55c3627912b9c849,hpg_9d140ea335b9efd4,2017-03-31,16,4,32,20
air_55c3627912b9c849,hpg_9d140ea335b9efd4,2017-04-01,12,2,21,14
air_55c3627912b9c849,hpg_9d140ea335b9efd4,2017-04-06,7,3,10,10
air_55c3627912b9c849,hpg_9d140ea335b9efd4,2017-04-14,7,3,16,10
air_55c3627912b9c849,hpg_9d140ea335b9efd4,2017-04-17,2,2,9,4
air_55c3627912b9c849,hpg_9d140ea335b9efd4,2017-04-19,5,3,13,8
air_55c3627912b9c849,hpg_9d140ea335b9efd4,2017-04-21,2,2,14,4
air_55c3627912b9c849,hpg_9d140ea335b9efd4,2017-04-22,4,2,12,6
air_066f0221b8a4d533,hpg_2777ed87df2eef7a,2016-10-28,11,4,17,15
air_066f0221b8a4d533,hpg_2777ed87df2eef7a,2016-10-29,15,4,25,19
air_066f0221b8a4d533,hpg_2777ed87df2eef7a,2016-11-19,10,2,15,12
air_066f0221b8a4d533,hpg_2777ed87df2eef7a,2016-11-29,13,12,15,25
air_066f0221b8a4d533,hpg_2777ed87df2eef7a,2016-12-09,18,30,33,48
air_066f0221b8a4d533,hpg_2777ed87df2eef7a,2016-12-10,13,13,19,26
air_066f0221b8a4d533,hpg_2777ed87df2eef7a,2016-12-16,14,16,23,30
air_066f0221b8a4d533,hpg_2777ed87df2eef7a,2016-12-17,24,31,28,55
air_066f0221b8a4d533,hpg_2777ed87df2eef7a,2016-12-20,3,3,9,6
air_066f0221b8a4d533,hpg_2777ed87df2eef7a,2016-12-27,10,2,15,12
air_066f0221b8a4d533,hpg_2777ed87df2eef7a,2016-12-28,19,6,34,25
air_066f0221b8a4d533,hpg_2777ed87df2eef7a,2017-01-03,8,8,14,16
air_066f0221b8a4d533,hpg_2777ed87df2eef7a,2017-01-06,9,9,26,18
air_066f0221b8a4d533,hpg_2777ed87df2eef7a,2017-01-14,7,6,22,13
air_066f0221b8a4d533,hpg_2777ed87df2eef7a,2017-01-21,6,6,25,12
air_066f0221b8a4d533,hpg_2777ed87df2eef7a,2017-01-27,10,3,30,13
air_066f0221b8a4d533,hpg_2777ed87df2eef7a,2017-01-31,4,4,11,8
air_066f0221b8a4d533,hpg_2777ed87df2eef7a,2017-02-17,7,7,26,14
air_066f0221b8a4d533,hpg_2777ed87df2eef7a,2017-02-18,4,4,17,8
air_066f0221b8a4d533,hpg_2777ed87df2eef7a,2017-03-10,9,9,18,18
air_066f0221b8a4d533,hpg_2777ed87df2eef7a,2017-03-13,8,8,17,16
air_066f0221b8a4d533,hpg_2777ed87df2eef7a,2017-03-16,2,2,24,4
air_066f0221b8a4d533,hpg_2777ed87df2eef7a,2017-03-17,21,6,26,27
air_066f0221b8a4d533,hpg_2777ed87df2eef7a,2017-03-24,6,2,16,8
air_066f0221b8a4d533,hpg_2777ed87df2eef7a,2017-04-01,19,11,38,30
air_066f0221b8a4d533,hpg_2777ed87df2eef7a,2017-04-06,8,8,18,16
air_066f0221b8a4d533,hpg_2777ed87df2eef7a,2017-04-07,6,3,19,9
air_066f0221b8a4d533,hpg_2777ed87df2eef7a,2017-04-12,2,2,6,4
air_cf2229e64408d9fe,hpg_e41e0f2c318dd8e4,2017-04-20,2,2,16,4
air_e89735e80d614a7e,hpg_b0cbb707b862dde7,2016-10-28,4,4,47,8
air_e89735e80d614a7e,hpg_b0cbb707b862dde7,2016-11-08,9,3,28,12
air_e89735e80d614a7e,hpg_b0cbb707b862dde7,2016-11-09,31,11,34,42
air_e89735e80d614a7e,hpg_b0cbb707b862dde7,2016-11-25,9,3,30,12
air_e89735e80d614a7e,hpg_b0cbb707b862dde7,2016-11-28,14,8,32,22
air_e89735e80d614a7e,hpg_b0cbb707b862dde7,2016-11-30,13,2,35,15
air_e89735e80d614a7e,hpg_b0cbb707b862dde7,2016-12-02,20,5,48,25
air_e89735e80d614a7e,hpg_b0cbb707b862dde7,2016-12-05,14,3,35,17
air_e89735e80d614a7e,hpg_b0cbb707b862dde7,2016-12-06,2,2,16,4
air_e89735e80d614a7e,hpg_b0cbb707b862dde7,2016-12-12,31,4,42,35
air_e89735e80d614a7e,hpg_b0cbb707b862dde7,2016-12-15,3,3,33,6
air_e89735e80d614a7e,hpg_b0cbb707b862dde7,2016-12-16,21,5,67,26
air_e89735e80d614a7e,hpg_b0cbb707b862dde7,2016-12-17,9,5,46,14
air_e89735e80d614a7e,hpg_b0cbb707b862dde7,2016-12-20,20,10,35,30
air_e89735e80d614a7e,hpg_b0cbb707b862dde7,2016-12-22,57,18,71,75
air_e89735e80d614a7e,hpg_b0cbb707b862dde7,2016-12-27,23,8,53,31
air_e89735e80d614a7e,hpg_b0cbb707b862dde7,2017-01-16,21,17,39,38
air_e89735e80d614a7e,hpg_b0cbb707b862dde7,2017-01-18,8,8,31,16
air_e89735e80d614a7e,hpg_b0cbb707b862dde7,2017-01-20,10,10,51,20
air_e89735e80d614a7e,hpg_b0cbb707b862dde7,2017-01-28,5,5,17,10
air_e89735e80d614a7e,hpg_b0cbb707b862dde7,2017-01-30,7,3,21,10
air_e89735e80d614a7e,hpg_b0cbb707b862dde7,2017-02-15,3,3,26,6
air_e89735e80d614a7e,hpg_b0cbb707b862dde7,2017-02-21,8,8,36,16
air_e89735e80d614a7e,hpg_b0cbb707b862dde7,2017-02-23,7,7,16,14
air_e89735e80d614a7e,hpg_b0cbb707b862dde7,2017-02-24,2,2,55,4
air_e89735e80d614a7e,hpg_b0cbb707b862dde7,2017-03-23,10,10,39,20
air_e89735e80d614a7e,hpg_b0cbb707b862dde7,2017-03-24,5,5,42,10
air_e89735e80d614a7e,hpg_b0cbb707b862dde7,2017-03-31,10,16,48,26
air_f180301886c21375,hpg_381bc6f038ec3ea8,2016-10-29,13,6,21,19
air_f180301886c21375,hpg_381bc6f038ec3ea8,2016-10-30,4,2,6,6
air_f180301886c21375,hpg_381bc6f038ec3ea8,2016-10-31,2,2,4,4
air_f180301886c21375,hpg_381bc6f038ec3ea8,2016-11-02,2,5,4,7
air_f180301886c21375,hpg_381bc6f038ec3ea8,2016-11-04,7,2,22,9
air_f180301886c21375,hpg_381bc6f038ec3ea8,2016-11-05,11,4,20,15
air_f180301886c21375,hpg_381bc6f038ec3ea8,2016-11-06,6,2,8,8
air_f180301886c21375,hpg_381bc6f038ec3ea8,2016-11-07,2,2,6,4
air_f180301886c21375,hpg_381bc6f038ec3ea8,2016-11-11,4,2,14,6
air_f180301886c21375,hpg_381bc6f038ec3ea8,2016-11-14,5,5,5,10
air_f180301886c21375,hpg_381bc6f038ec3ea8,2016-11-17,5,2,4,7
air_f180301886c21375,hpg_381bc6f038ec3ea8,2016-11-18,11,5,18,16
air_f180301886c21375,hpg_381bc6f038ec3ea8,2016-11-19,14,4,22,18
air_f180301886c21375,hpg_381bc6f038ec3ea8,2016-11-22,19,6,25,25
air_f180301886c21375,hpg_381bc6f038ec3ea8,2016-11-23,5,5,5,10
air_f180301886c21375,hpg_381bc6f038ec3ea8,2016-11-25,21,2,23,23
air_f180301886c21375,hpg_381bc6f038ec3ea8,2016-11-27,8,2,19,10
air_f180301886c21375,hpg_381bc6f038ec3ea8,2016-12-01,11,7,11,18
air_f180301886c21375,hpg_381bc6f038ec3ea8,2016-12-02,28,8,28,36
air_f180301886c21375,hpg_381bc6f038ec3ea8,2016-12-03,14,6,24,20
air_f180301886c21375,hpg_381bc6f038ec3ea8,2016-12-04,19,11,30,30
air_f180301886c21375,hpg_381bc6f038ec3ea8,2016-12-08,9,3,11,12
air_f180301886c21375,hpg_381bc6f038ec3ea8,2016-12-09,13,6,19,19
air_f180301886c21375,hpg_381bc6f038ec3ea8,2016-12-10,23,8,23,31
air_f180301886c21375,hpg_381bc6f038ec3ea8,2016-12-11,2,2,23,4
air_f180301886c21375,hpg_381bc6f038ec3ea8,2016-12-13,17,3,14,20
air_f180301886c21375,hpg_381bc6f038ec3ea8,2016-12-15,9,3,14,12
air_f180301886c21375,hpg_381bc6f038ec3ea8,2016-12-17,10,8,22,18
air_f180301886c21375,hpg_381bc6f038ec3ea8,2016-12-18,4,2,10,6
air_f180301886c21375,hpg_381bc6f038ec3ea8,2016-12-20,12,5,16,17
air_f180301886c21375,hpg_381bc6f038ec3ea8,2016-12-22,14,4,22,18
air_f180301886c21375,hpg_381bc6f038ec3ea8,2016-12-23,2,2,13,4
air_f180301886c21375,hpg_381bc6f038ec3ea8,2016-12-24,19,20,16,39
air_f180301886c21375,hpg_381bc6f038ec3ea8,2016-12-25,23,14,44,37
air_f180301886c21375,hpg_381bc6f038ec3ea8,2016-12-26,9,9,21,18
air_f180301886c21375,hpg_381bc6f038ec3ea8,2016-12-27,9,2,17,11
air_f180301886c21375,hpg_381bc6f038ec3ea8,2016-12-29,25,9,29,34
air_f180301886c21375,hpg_381bc6f038ec3ea8,2016-12-30,23,7,24,30
air_f180301886c21375,hpg_381bc6f038ec3ea8,2016-12-31,4,4,35,8
air_f180301886c21375,hpg_381bc6f038ec3ea8,2017-01-01,4,3,25,7
air_f180301886c21375,hpg_381bc6f038ec3ea8,2017-01-03,2,2,32,4
air_f180301886c21375,hpg_381bc6f038ec3ea8,2017-01-05,6,6,6,12
air_f180301886c21375,hpg_381bc6f038ec3ea8,2017-01-06,8,8,24,16
air_f180301886c21375,hpg_381bc6f038ec3ea8,2017-01-07,9,12,20,21
air_f180301886c21375,hpg_381bc6f038ec3ea8,2017-01-08,14,3,20,17
air_f180301886c21375,hpg_381bc6f038ec3ea8,2017-01-09,2,2,12,4
air_f180301886c21375,hpg_381bc6f038ec3ea8,2017-01-14,11,4,21,15
air_f180301886c21375,hpg_381bc6f038ec3ea8,2017-01-20,21,8,21,29
air_f180301886c21375,hpg_381bc6f038ec3ea8,2017-01-21,7,2,13,9
air_f180301886c21375,hpg_381bc6f038ec3ea8,2017-01-24,5,2,7,7
air_f180301886c21375,hpg_381bc6f038ec3ea8,2017-01-26,27,4,29,31
air_f180301886c21375,hpg_381bc6f038ec3ea8,2017-01-27,8,8,24,16
air_f180301886c21375,hpg_381bc6f038ec3ea8,2017-01-29,6,4,10,10
air_f180301886c21375,hpg_381bc6f038ec3ea8,2017-02-01,2,2,2,4
air_f180301886c21375,hpg_381bc6f038ec3ea8,2017-02-02,2,2,4,4
air_f180301886c21375,hpg_381bc6f038ec3ea8,2017-02-03,18,11,23,29
air_f180301886c21375,hpg_381bc6f038ec3ea8,2017-02-04,11,4,22,15
air_f180301886c21375,hpg_381bc6f038ec3ea8,2017-02-05,7,2,23,9
air_f180301886c21375,hpg_381bc6f038ec3ea8,2017-02-06,5,5,7,10
air_f180301886c21375,hpg_381bc6f038ec3ea8,2017-02-07,4,4,9,8
air_f180301886c21375,hpg_381bc6f038ec3ea8,2017-02-08,6,2,17,8
air_f180301886c21375,hpg_381bc6f038ec3ea8,2017-02-09,2,2,8,4
air_f180301886c21375,hpg_381bc6f038ec3ea8,2017-02-10,14,4,25,18
air_f180301886c21375,hpg_381bc6f038ec3ea8,2017-02-11,9,5,24,14
air_f180301886c21375,hpg_381bc6f038ec3ea8,2017-02-12,15,3,25,18
air_f180301886c21375,hpg_381bc6f038ec3ea8,2017-02-13,4,2,7,6
air_f180301886c21375,hpg_381bc6f038ec3ea8,2017-02-16,25,12,21,37
air_f180301886c21375,hpg_381bc6f038ec3ea8,2017-02-18,17,3,24,20
air_f180301886c21375,hpg_381bc6f038ec3ea8,2017-02-19,3,3,18,6
air_f180301886c21375,hpg_381bc6f038ec3ea8,2017-02-20,6,2,8,8
air_f180301886c21375,hpg_381bc6f038ec3ea8,2017-02-22,4,2,9,6
air_f180301886c21375,hpg_381bc6f038ec3ea8,2017-02-25,13,2,26,15
air_f180301886c21375,hpg_381bc6f038ec3ea8,2017-02-26,11,11,25,22
air_f180301886c21375,hpg_381bc6f038ec3ea8,2017-02-27,6,2,23,8
air_f180301886c21375,hpg_381bc6f038ec3ea8,2017-03-02,7,5,15,12
air_f180301886c21375,hpg_381bc6f038ec3ea8,2017-03-04,12,6,31,18
air_f180301886c21375,hpg_381bc6f038ec3ea8,2017-03-05,11,4,24,15
air_f180301886c21375,hpg_381bc6f038ec3ea8,2017-03-09,4,2,4,6
air_f180301886c21375,hpg_381bc6f038ec3ea8,2017-03-10,15,2,21,17
air_f180301886c21375,hpg_381bc6f038ec3ea8,2017-03-11,17,7,33,24
air_f180301886c21375,hpg_381bc6f038ec3ea8,2017-03-12,14,10,22,24
air_f180301886c21375,hpg_381bc6f038ec3ea8,2017-03-14,11,14,17,25
air_f180301886c21375,hpg_381bc6f038ec3ea8,2017-03-15,5,3,9,8
air_f180301886c21375,hpg_381bc6f038ec3ea8,2017-03-17,23,35,37,58
air_f180301886c21375,hpg_381bc6f038ec3ea8,2017-03-18,7,7,19,14
air_f180301886c21375,hpg_381bc6f038ec3ea8,2017-03-19,14,12,29,26
air_f180301886c21375,hpg_381bc6f038ec3ea8,2017-03-22,5,3,11,8
air_f180301886c21375,hpg_381bc6f038ec3ea8,2017-03-23,9,9,16,18
air_f180301886c21375,hpg_381bc6f038ec3ea8,2017-03-24,19,21,41,40
air_f180301886c21375,hpg_381bc6f038ec3ea8,2017-03-25,6,2,19,8
air_f180301886c21375,hpg_381bc6f038ec3ea8,2017-03-26,13,6,29,19
air_f180301886c21375,hpg_381bc6f038ec3ea8,2017-03-28,2,2,8,4
air_f180301886c21375,hpg_381bc6f038ec3ea8,2017-03-29,30,6,42,36
air_f180301886c21375,hpg_381bc6f038ec3ea8,2017-03-30,2,2,7,4
air_f180301886c21375,hpg_381bc6f038ec3ea8,2017-03-31,10,3,24,13
air_f180301886c21375,hpg_381bc6f038ec3ea8,2017-04-01,11,9,25,20
air_f180301886c21375,hpg_381bc6f038ec3ea8,2017-04-02,6,4,18,10
air_f180301886c21375,hpg_381bc6f038ec3ea8,2017-04-03,14,2,14,16
air_f180301886c21375,hpg_381bc6f038ec3ea8,2017-04-04,2,2,2,4
air_f180301886c21375,hpg_381bc6f038ec3ea8,2017-04-05,6,4,8,10
air_f180301886c21375,hpg_381bc6f038ec3ea8,2017-04-06,2,2,7,4
air_f180301886c21375,hpg_381bc6f038ec3ea8,2017-04-08,8,15,21,23
air_f180301886c21375,hpg_381bc6f038ec3ea8,2017-04-10,8,8,18,16
air_f180301886c21375,hpg_381bc6f038ec3ea8,2017-04-14,4,4,14,8
air_f180301886c21375,hpg_381bc6f038ec3ea8,2017-04-16,4,2,18,6
air_f180301886c21375,hpg_381bc6f038ec3ea8,2017-04-21,16,12,26,28
air_c225148c0fcc5c72,hpg_ee424bb170e133f1,2016-10-29,4,8,43,12
air_c225148c0fcc5c72,hpg_ee424bb170e133f1,2016-11-02,2,2,10,4
air_c225148c0fcc5c72,hpg_ee424bb170e133f1,2016-11-17,2,2,23,4
air_c225148c0fcc5c72,hpg_ee424bb170e133f1,2016-11-23,3,3,50,6
air_c225148c0fcc5c72,hpg_ee424bb170e133f1,2016-11-26,4,4,35,8
air_c225148c0fcc5c72,hpg_ee424bb170e133f1,2016-12-02,4,4,19,8
air_c225148c0fcc5c72,hpg_ee424bb170e133f1,2016-12-06,2,2,22,4
air_c225148c0fcc5c72,hpg_ee424bb170e133f1,2016-12-07,2,2,41,4
air_c225148c0fcc5c72,hpg_ee424bb170e133f1,2016-12-20,3,3,12,6
air_c225148c0fcc5c72,hpg_ee424bb170e133f1,2016-12-24,4,4,57,8
air_c225148c0fcc5c72,hpg_ee424bb170e133f1,2016-12-25,4,4,50,8
air_c225148c0fcc5c72,hpg_ee424bb170e133f1,2017-01-24,2,2,24,4
air_c225148c0fcc5c72,hpg_ee424bb170e133f1,2017-02-08,2,2,38,4
air_c225148c0fcc5c72,hpg_ee424bb170e133f1,2017-04-08,5,5,46,10
air_c225148c0fcc5c72,hpg_ee424bb170e133f1,2017-04-11,1,1,22,2
air_08ef81d5b7a0d13f,hpg_ba2ce254969629b8,2016-10-28,2,2,16,4
air_08ef81d5b7a0d13f,hpg_ba2ce254969629b8,2016-11-04,6,2,24,8
air_08ef81d5b7a0d13f,hpg_ba2ce254969629b8,2016-12-03,2,2,9,4
air_08ef81d5b7a0d13f,hpg_ba2ce254969629b8,2016-12-08,7,2,23,9
air_08ef81d5b7a0d13f,hpg_ba2ce254969629b8,2016-12-16,13,10,22,23
air_08ef81d5b7a0d13f,hpg_ba2ce254969629b8,2016-12-19,6,2,12,8
air_08ef81d5b7a0d13f,hpg_ba2ce254969629b8,2016-12-20,19,9,32,28
air_08ef81d5b7a0d13f,hpg_ba2ce254969629b8,2016-12-26,14,2,14,16
air_08ef81d5b7a0d13f,hpg_ba2ce254969629b8,2016-12-27,7,2,33,9
air_08ef81d5b7a0d13f,hpg_ba2ce254969629b8,2016-12-30,2,2,8,4
air_08ef81d5b7a0d13f,hpg_ba2ce254969629b8,2017-01-20,5,1,26,6
air_08ef81d5b7a0d13f,hpg_ba2ce254969629b8,2017-02-01,4,2,18,6
air_08ef81d5b7a0d13f,hpg_ba2ce254969629b8,2017-02-15,2,2,14,4
air_08ef81d5b7a0d13f,hpg_ba2ce254969629b8,2017-02-17,18,3,25,21
air_08ef81d5b7a0d13f,hpg_ba2ce254969629b8,2017-02-22,2,2,10,4
air_08ef81d5b7a0d13f,hpg_ba2ce254969629b8,2017-02-28,14,14,16,28
air_08ef81d5b7a0d13f,hpg_ba2ce254969629b8,2017-03-15,2,2,8,4
air_08ef81d5b7a0d13f,hpg_ba2ce254969629b8,2017-03-22,17,17,18,34
air_08ef81d5b7a0d13f,hpg_ba2ce254969629b8,2017-03-24,17,9,20,26
air_08ef81d5b7a0d13f,hpg_ba2ce254969629b8,2017-04-05,14,2,18,16
air_08ef81d5b7a0d13f,hpg_ba2ce254969629b8,2017-04-14,14,6,31,20
air_63b13c56b7201bd9,hpg_4bc649e72e2a239a,2017-02-11,14,3,51,17
air_63b13c56b7201bd9,hpg_4bc649e72e2a239a,2017-02-24,6,7,19,13
air_63b13c56b7201bd9,hpg_4bc649e72e2a239a,2017-02-25,6,9,65,15
air_63b13c56b7201bd9,hpg_4bc649e72e2a239a,2017-03-14,6,2,48,8
air_63b13c56b7201bd9,hpg_4bc649e72e2a239a,2017-04-07,4,4,29,8
air_7cc17a324ae5c7dc,hpg_9b38b9e13da6da27,2016-06-19,2,8,14,10
air_7cc17a324ae5c7dc,hpg_9b38b9e13da6da27,2016-11-18,2,2,2,4
air_7cc17a324ae5c7dc,hpg_9b38b9e13da6da27,2016-11-25,21,21,21,42
air_7cc17a324ae5c7dc,hpg_9b38b9e13da6da27,2016-11-27,18,8,18,26
air_7cc17a324ae5c7dc,hpg_9b38b9e13da6da27,2016-12-02,12,6,21,18
air_7cc17a324ae5c7dc,hpg_9b38b9e13da6da27,2016-12-03,36,6,48,42
air_7cc17a324ae5c7dc,hpg_9b38b9e13da6da27,2016-12-07,6,2,8,8
air_7cc17a324ae5c7dc,hpg_9b38b9e13da6da27,2016-12-13,3,4,9,7
air_7cc17a324ae5c7dc,hpg_9b38b9e13da6da27,2016-12-17,4,2,44,6
air_7cc17a324ae5c7dc,hpg_9b38b9e13da6da27,2016-12-18,7,4,25,11
air_7cc17a324ae5c7dc,hpg_9b38b9e13da6da27,2016-12-22,17,4,23,21
air_7cc17a324ae5c7dc,hpg_9b38b9e13da6da27,2016-12-23,4,4,17,8
air_7cc17a324ae5c7dc,hpg_9b38b9e13da6da27,2016-12-24,11,23,31,34
air_7cc17a324ae5c7dc,hpg_9b38b9e13da6da27,2016-12-25,13,2,31,15
air_7cc17a324ae5c7dc,hpg_9b38b9e13da6da27,2016-12-28,8,5,10,13
air_7cc17a324ae5c7dc,hpg_9b38b9e13da6da27,2016-12-29,5,2,14,7
air_7cc17a324ae5c7dc,hpg_9b38b9e13da6da27,2017-01-03,5,5,15,10
air_7cc17a324ae5c7dc,hpg_9b38b9e13da6da27,2017-01-06,2,2,6,4
air_7cc17a324ae5c7dc,hpg_9b38b9e13da6da27,2017-01-08,5,6,9,11
air_7cc17a324ae5c7dc,hpg_9b38b9e13da6da27,2017-01-24,4,4,4,8
air_7cc17a324ae5c7dc,hpg_9b38b9e13da6da27,2017-02-04,7,2,30,9
air_7cc17a324ae5c7dc,hpg_9b38b9e13da6da27,2017-02-05,10,5,24,15
air_7cc17a324ae5c7dc,hpg_9b38b9e13da6da27,2017-02-11,13,8,48,21
air_7cc17a324ae5c7dc,hpg_9b38b9e13da6da27,2017-02-12,10,7,16,17
air_7cc17a324ae5c7dc,hpg_9b38b9e13da6da27,2017-02-18,10,8,32,18
air_7cc17a324ae5c7dc,hpg_9b38b9e13da6da27,2017-02-26,6,6,14,12
air_7cc17a324ae5c7dc,hpg_9b38b9e13da6da27,2017-03-03,2,2,2,4
air_7cc17a324ae5c7dc,hpg_9b38b9e13da6da27,2017-03-04,4,4,11,8
air_7cc17a324ae5c7dc,hpg_9b38b9e13da6da27,2017-03-05,5,3,19,8
air_7cc17a324ae5c7dc,hpg_9b38b9e13da6da27,2017-03-06,8,5,11,13
air_7cc17a324ae5c7dc,hpg_9b38b9e13da6da27,2017-03-11,15,5,31,20
air_7cc17a324ae5c7dc,hpg_9b38b9e13da6da27,2017-03-12,6,3,22,9
air_7cc17a324ae5c7dc,hpg_9b38b9e13da6da27,2017-03-18,2,2,21,4
air_7cc17a324ae5c7dc,hpg_9b38b9e13da6da27,2017-03-19,3,3,10,6
air_7cc17a324ae5c7dc,hpg_9b38b9e13da6da27,2017-03-20,7,8,34,15
air_7cc17a324ae5c7dc,hpg_9b38b9e13da6da27,2017-03-25,23,18,35,41
air_7cc17a324ae5c7dc,hpg_9b38b9e13da6da27,2017-03-26,5,7,19,12
air_7cc17a324ae5c7dc,hpg_9b38b9e13da6da27,2017-03-27,3,4,3,7
air_7cc17a324ae5c7dc,hpg_9b38b9e13da6da27,2017-03-31,6,6,16,12
air_7cc17a324ae5c7dc,hpg_9b38b9e13da6da27,2017-04-01,2,2,14,4
air_7cc17a324ae5c7dc,hpg_9b38b9e13da6da27,2017-04-08,9,7,18,16
air_7cc17a324ae5c7dc,hpg_9b38b9e13da6da27,2017-04-15,25,2,29,27
air_7cc17a324ae5c7dc,hpg_9b38b9e13da6da27,2017-04-16,19,30,35,49
air_7cc17a324ae5c7dc,hpg_9b38b9e13da6da27,2017-04-18,2,2,8,4
air_7cc17a324ae5c7dc,hpg_9b38b9e13da6da27,2017-04-21,3,1,5,4
air_7cc17a324ae5c7dc,hpg_9b38b9e13da6da27,2017-04-22,32,8,45,40
air_28064154614b2e6c,hpg_2ecfd31844d0ba36,2016-10-31,6,6,11,12
air_28064154614b2e6c,hpg_2ecfd31844d0ba36,2016-11-01,15,5,30,20
air_28064154614b2e6c,hpg_2ecfd31844d0ba36,2016-11-29,9,10,18,19
air_28064154614b2e6c,hpg_2ecfd31844d0ba36,2016-12-20,4,4,19,8
air_28064154614b2e6c,hpg_2ecfd31844d0ba36,2016-12-26,8,10,20,18
air_28064154614b2e6c,hpg_2ecfd31844d0ba36,2017-01-06,19,16,28,35
air_28064154614b2e6c,hpg_2ecfd31844d0ba36,2017-02-03,22,4,29,26
air_28064154614b2e6c,hpg_2ecfd31844d0ba36,2017-02-13,9,5,14,14
air_28064154614b2e6c,hpg_2ecfd31844d0ba36,2017-02-27,6,6,10,12
air_28064154614b2e6c,hpg_2ecfd31844d0ba36,2017-03-01,19,4,25,23
air_28064154614b2e6c,hpg_2ecfd31844d0ba36,2017-03-15,15,10,28,25
air_28064154614b2e6c,hpg_2ecfd31844d0ba36,2017-03-16,8,5,22,13
air_28064154614b2e6c,hpg_2ecfd31844d0ba36,2017-04-10,11,4,19,15
air_8f3b563416efc6ad,hpg_d12fb3b2b4129cd6,2016-10-28,2,2,18,4
air_8f3b563416efc6ad,hpg_d12fb3b2b4129cd6,2016-10-29,7,2,20,9
air_8f3b563416efc6ad,hpg_d12fb3b2b4129cd6,2016-10-30,2,2,16,4
air_8f3b563416efc6ad,hpg_d12fb3b2b4129cd6,2016-11-05,2,2,21,4
air_8f3b563416efc6ad,hpg_d12fb3b2b4129cd6,2016-11-06,1,1,13,2
air_8f3b563416efc6ad,hpg_d12fb3b2b4129cd6,2016-11-07,2,2,14,4
air_8f3b563416efc6ad,hpg_d12fb3b2b4129cd6,2016-11-12,7,4,25,11
air_8f3b563416efc6ad,hpg_d12fb3b2b4129cd6,2016-11-18,8,2,18,10
air_8f3b563416efc6ad,hpg_d12fb3b2b4129cd6,2016-11-19,8,3,27,11
air_8f3b563416efc6ad,hpg_d12fb3b2b4129cd6,2016-11-20,2,2,17,4
air_8f3b563416efc6ad,hpg_d12fb3b2b4129cd6,2016-11-21,3,3,15,6
air_8f3b563416efc6ad,hpg_d12fb3b2b4129cd6,2016-11-22,2,6,22,8
air_8f3b563416efc6ad,hpg_d12fb3b2b4129cd6,2016-11-25,4,4,14,8
air_8f3b563416efc6ad,hpg_d12fb3b2b4129cd6,2016-11-26,15,10,26,25
air_8f3b563416efc6ad,hpg_d12fb3b2b4129cd6,2016-11-27,5,3,23,8
air_8f3b563416efc6ad,hpg_d12fb3b2b4129cd6,2016-12-02,4,4,12,8
air_8f3b563416efc6ad,hpg_d12fb3b2b4129cd6,2016-12-03,7,4,22,11
air_8f3b563416efc6ad,hpg_d12fb3b2b4129cd6,2016-12-04,4,8,15,12
air_8f3b563416efc6ad,hpg_d12fb3b2b4129cd6,2016-12-05,2,2,16,4
air_8f3b563416efc6ad,hpg_d12fb3b2b4129cd6,2016-12-07,2,2,9,4
air_8f3b563416efc6ad,hpg_d12fb3b2b4129cd6,2016-12-09,4,2,22,6
air_8f3b563416efc6ad,hpg_d12fb3b2b4129cd6,2016-12-15,3,3,18,6
air_8f3b563416efc6ad,hpg_d12fb3b2b4129cd6,2016-12-16,6,9,20,15
air_8f3b563416efc6ad,hpg_d12fb3b2b4129cd6,2016-12-19,4,2,19,6
air_8f3b563416efc6ad,hpg_d12fb3b2b4129cd6,2016-12-22,8,2,23,10
air_8f3b563416efc6ad,hpg_d12fb3b2b4129cd6,2016-12-23,2,2,15,4
air_8f3b563416efc6ad,hpg_d12fb3b2b4129cd6,2016-12-24,2,2,15,4
air_8f3b563416efc6ad,hpg_d12fb3b2b4129cd6,2016-12-28,4,9,23,13
air_8f3b563416efc6ad,hpg_d12fb3b2b4129cd6,2017-01-07,5,3,10,8
air_8f3b563416efc6ad,hpg_d12fb3b2b4129cd6,2017-01-10,3,3,15,6
air_8f3b563416efc6ad,hpg_d12fb3b2b4129cd6,2017-01-13,2,2,11,4
air_8f3b563416efc6ad,hpg_d12fb3b2b4129cd6,2017-01-18,2,2,12,4
air_8f3b563416efc6ad,hpg_d12fb3b2b4129cd6,2017-01-22,2,2,20,4
air_8f3b563416efc6ad,hpg_d12fb3b2b4129cd6,2017-01-27,8,8,22,16
air_8f3b563416efc6ad,hpg_d12fb3b2b4129cd6,2017-02-05,2,2,18,4
air_8f3b563416efc6ad,hpg_d12fb3b2b4129cd6,2017-02-10,4,2,15,6
air_8f3b563416efc6ad,hpg_d12fb3b2b4129cd6,2017-02-11,2,2,15,4
air_8f3b563416efc6ad,hpg_d12fb3b2b4129cd6,2017-02-17,5,5,11,10
air_8f3b563416efc6ad,hpg_d12fb3b2b4129cd6,2017-02-22,3,3,15,6
air_8f3b563416efc6ad,hpg_d12fb3b2b4129cd6,2017-02-24,4,4,17,8
air_8f3b563416efc6ad,hpg_d12fb3b2b4129cd6,2017-02-25,6,4,19,10
air_8f3b563416efc6ad,hpg_d12fb3b2b4129cd6,2017-03-02,3,3,15,6
air_8f3b563416efc6ad,hpg_d12fb3b2b4129cd6,2017-03-05,2,2,11,4
air_8f3b563416efc6ad,hpg_d12fb3b2b4129cd6,2017-03-24,10,7,16,17
air_8f3b563416efc6ad,hpg_d12fb3b2b4129cd6,2017-03-25,4,4,19,8
air_8f3b563416efc6ad,hpg_d12fb3b2b4129cd6,2017-03-31,3,3,21,6
air_8f3b563416efc6ad,hpg_d12fb3b2b4129cd6,2017-04-14,2,5,15,7
air_646b93e336f0dded,hpg_b3de3ba6437e5a11,2016-07-20,6,2,14,8
air_646b93e336f0dded,hpg_b3de3ba6437e5a11,2016-10-29,2,4,6,6
air_646b93e336f0dded,hpg_b3de3ba6437e5a11,2016-11-19,15,2,5,17
air_646b93e336f0dded,hpg_b3de3ba6437e5a11,2016-11-26,9,9,23,18
air_646b93e336f0dded,hpg_b3de3ba6437e5a11,2016-12-03,14,15,21,29
air_646b93e336f0dded,hpg_b3de3ba6437e5a11,2016-12-05,2,2,5,4
air_646b93e336f0dded,hpg_b3de3ba6437e5a11,2016-12-08,5,2,11,7
air_646b93e336f0dded,hpg_b3de3ba6437e5a11,2016-12-19,74,8,78,82
air_646b93e336f0dded,hpg_b3de3ba6437e5a11,2016-12-28,22,21,20,43
air_646b93e336f0dded,hpg_b3de3ba6437e5a11,2016-12-29,6,10,13,16
air_646b93e336f0dded,hpg_b3de3ba6437e5a11,2016-12-30,24,6,26,30
air_646b93e336f0dded,hpg_b3de3ba6437e5a11,2016-12-31,2,4,6,6
air_646b93e336f0dded,hpg_b3de3ba6437e5a11,2017-01-01,11,3,18,14
air_646b93e336f0dded,hpg_b3de3ba6437e5a11,2017-01-02,4,4,9,8
air_646b93e336f0dded,hpg_b3de3ba6437e5a11,2017-01-04,2,2,11,4
air_646b93e336f0dded,hpg_b3de3ba6437e5a11,2017-01-07,22,4,21,26
air_646b93e336f0dded,hpg_b3de3ba6437e5a11,2017-01-14,11,3,7,14
air_646b93e336f0dded,hpg_b3de3ba6437e5a11,2017-01-27,7,10,19,17
air_646b93e336f0dded,hpg_b3de3ba6437e5a11,2017-02-03,15,2,21,17
air_646b93e336f0dded,hpg_b3de3ba6437e5a11,2017-02-16,7,4,8,11
air_646b93e336f0dded,hpg_b3de3ba6437e5a11,2017-02-24,3,3,5,6
air_646b93e336f0dded,hpg_b3de3ba6437e5a11,2017-03-03,2,5,1,7
air_646b93e336f0dded,hpg_b3de3ba6437e5a11,2017-03-10,3,3,9,6
air_646b93e336f0dded,hpg_b3de3ba6437e5a11,2017-03-11,2,2,13,4
air_646b93e336f0dded,hpg_b3de3ba6437e5a11,2017-03-14,12,4,16,16
air_646b93e336f0dded,hpg_b3de3ba6437e5a11,2017-03-22,2,2,18,4
air_646b93e336f0dded,hpg_b3de3ba6437e5a11,2017-03-28,8,2,10,10
air_646b93e336f0dded,hpg_b3de3ba6437e5a11,2017-03-29,3,3,15,6
air_646b93e336f0dded,hpg_b3de3ba6437e5a11,2017-03-31,4,2,9,6
air_646b93e336f0dded,hpg_b3de3ba6437e5a11,2017-04-14,5,2,10,7
air_646b93e336f0dded,hpg_b3de3ba6437e5a11,2017-04-20,10,2,8,12
air_e00fe7853c0100d6,hpg_d59fec517d99991f,2016-11-26,18,3,49,21
air_e00fe7853c0100d6,hpg_d59fec517d99991f,2016-12-01,20,16,30,36
air_e00fe7853c0100d6,hpg_d59fec517d99991f,2016-12-02,25,2,27,27
air_e00fe7853c0100d6,hpg_d59fec517d99991f,2016-12-03,21,9,28,30
air_e00fe7853c0100d6,hpg_d59fec517d99991f,2016-12-09,16,36,27,52
air_e00fe7853c0100d6,hpg_d59fec517d99991f,2016-12-10,33,7,40,40
air_e00fe7853c0100d6,hpg_d59fec517d99991f,2016-12-12,10,4,29,14
air_e00fe7853c0100d6,hpg_d59fec517d99991f,2016-12-16,20,2,30,22
air_e00fe7853c0100d6,hpg_d59fec517d99991f,2016-12-17,33,9,43,42
air_e00fe7853c0100d6,hpg_d59fec517d99991f,2016-12-18,17,3,24,20
air_e00fe7853c0100d6,hpg_d59fec517d99991f,2016-12-21,10,2,14,12
air_e00fe7853c0100d6,hpg_d59fec517d99991f,2016-12-23,21,2,43,23
air_e00fe7853c0100d6,hpg_d59fec517d99991f,2016-12-27,22,16,23,38
air_e00fe7853c0100d6,hpg_d59fec517d99991f,2016-12-28,27,8,42,35
air_e00fe7853c0100d6,hpg_d59fec517d99991f,2016-12-29,26,3,33,29
air_e00fe7853c0100d6,hpg_d59fec517d99991f,2016-12-30,28,8,28,36
air_e00fe7853c0100d6,hpg_d59fec517d99991f,2016-12-31,23,5,40,28
air_e00fe7853c0100d6,hpg_d59fec517d99991f,2017-01-01,28,14,26,42
air_e00fe7853c0100d6,hpg_d59fec517d99991f,2017-01-02,23,4,34,27
air_e00fe7853c0100d6,hpg_d59fec517d99991f,2017-01-03,23,13,34,36
air_e00fe7853c0100d6,hpg_d59fec517d99991f,2017-01-07,20,5,30,25
air_e00fe7853c0100d6,hpg_d59fec517d99991f,2017-01-08,14,2,31,16
air_e00fe7853c0100d6,hpg_d59fec517d99991f,2017-01-09,4,2,10,6
air_e00fe7853c0100d6,hpg_d59fec517d99991f,2017-01-10,10,2,19,12
air_e00fe7853c0100d6,hpg_d59fec517d99991f,2017-01-12,15,3,29,18
air_e00fe7853c0100d6,hpg_d59fec517d99991f,2017-01-13,5,5,18,10
air_e00fe7853c0100d6,hpg_d59fec517d99991f,2017-01-14,10,4,24,14
air_e00fe7853c0100d6,hpg_d59fec517d99991f,2017-01-15,7,2,7,9
air_e00fe7853c0100d6,hpg_d59fec517d99991f,2017-01-18,8,5,24,13
air_e00fe7853c0100d6,hpg_d59fec517d99991f,2017-01-27,30,16,29,46
air_e00fe7853c0100d6,hpg_d59fec517d99991f,2017-01-28,23,5,32,28
air_e00fe7853c0100d6,hpg_d59fec517d99991f,2017-01-29,19,12,33,31
air_e00fe7853c0100d6,hpg_d59fec517d99991f,2017-02-10,3,3,11,6
air_e00fe7853c0100d6,hpg_d59fec517d99991f,2017-02-11,24,8,36,32
air_e00fe7853c0100d6,hpg_d59fec517d99991f,2017-02-19,16,12,55,28
air_e00fe7853c0100d6,hpg_d59fec517d99991f,2017-02-20,12,6,14,18
air_e00fe7853c0100d6,hpg_d59fec517d99991f,2017-02-21,6,3,10,9
air_e00fe7853c0100d6,hpg_d59fec517d99991f,2017-02-24,10,12,21,22
air_e00fe7853c0100d6,hpg_d59fec517d99991f,2017-02-25,12,9,21,21
air_e00fe7853c0100d6,hpg_d59fec517d99991f,2017-02-26,8,3,30,11
air_e00fe7853c0100d6,hpg_d59fec517d99991f,2017-03-03,9,9,12,18
air_e00fe7853c0100d6,hpg_d59fec517d99991f,2017-03-04,20,2,35,22
air_e00fe7853c0100d6,hpg_d59fec517d99991f,2017-03-05,2,2,21,4
air_e00fe7853c0100d6,hpg_d59fec517d99991f,2017-03-06,20,4,30,24
air_e00fe7853c0100d6,hpg_d59fec517d99991f,2017-03-10,7,2,12,9
air_e00fe7853c0100d6,hpg_d59fec517d99991f,2017-03-11,20,10,24,30
air_e00fe7853c0100d6,hpg_d59fec517d99991f,2017-03-19,10,6,24,16
air_e00fe7853c0100d6,hpg_d59fec517d99991f,2017-03-20,16,2,36,18
air_e00fe7853c0100d6,hpg_d59fec517d99991f,2017-03-22,9,13,13,22
air_e00fe7853c0100d6,hpg_d59fec517d99991f,2017-03-24,26,5,29,31
air_e00fe7853c0100d6,hpg_d59fec517d99991f,2017-03-25,13,4,23,17
air_e00fe7853c0100d6,hpg_d59fec517d99991f,2017-03-26,13,7,23,20
air_e00fe7853c0100d6,hpg_d59fec517d99991f,2017-03-27,12,2,17,14
air_e00fe7853c0100d6,hpg_d59fec517d99991f,2017-03-28,12,9,32,21
air_e00fe7853c0100d6,hpg_d59fec517d99991f,2017-03-29,9,8,18,17
air_e00fe7853c0100d6,hpg_d59fec517d99991f,2017-04-01,2,2,11,4
air_e00fe7853c0100d6,hpg_d59fec517d99991f,2017-04-03,3,3,13,6
air_e00fe7853c0100d6,hpg_d59fec517d99991f,2017-04-06,12,2,19,14
air_e00fe7853c0100d6,hpg_d59fec517d99991f,2017-04-07,18,3,17,21
air_e00fe7853c0100d6,hpg_d59fec517d99991f,2017-04-08,19,5,47,24
air_e00fe7853c0100d6,hpg_d59fec517d99991f,2017-04-12,7,5,28,12
air_e00fe7853c0100d6,hpg_d59fec517d99991f,2017-04-13,11,8,13,19
air_e00fe7853c0100d6,hpg_d59fec517d99991f,2017-04-15,20,17,43,37
air_e00fe7853c0100d6,hpg_d59fec517d99991f,2017-04-21,21,2,28,23
air_e00fe7853c0100d6,hpg_d59fec517d99991f,2017-04-22,8,2,30,10
air_ef789667e2e6fe96,hpg_f76ad2d2d0134bdd,2016-04-09,2,6,55,8
air_ef789667e2e6fe96,hpg_f76ad2d2d0134bdd,2016-11-25,6,10,33,16
air_ef789667e2e6fe96,hpg_f76ad2d2d0134bdd,2016-12-02,2,4,24,6
air_ef789667e2e6fe96,hpg_f76ad2d2d0134bdd,2016-12-03,31,32,69,63
air_ef789667e2e6fe96,hpg_f76ad2d2d0134bdd,2016-12-05,6,6,27,12
air_ef789667e2e6fe96,hpg_f76ad2d2d0134bdd,2016-12-07,20,20,25,40
air_ef789667e2e6fe96,hpg_f76ad2d2d0134bdd,2016-12-13,7,7,24,14
air_ef789667e2e6fe96,hpg_f76ad2d2d0134bdd,2016-12-29,18,42,79,60
air_ef789667e2e6fe96,hpg_f76ad2d2d0134bdd,2017-01-21,6,6,37,12
air_ef789667e2e6fe96,hpg_f76ad2d2d0134bdd,2017-01-22,8,8,23,16
air_ef789667e2e6fe96,hpg_f76ad2d2d0134bdd,2017-01-25,12,12,32,24
air_ef789667e2e6fe96,hpg_f76ad2d2d0134bdd,2017-02-02,3,3,28,6
air_ef789667e2e6fe96,hpg_f76ad2d2d0134bdd,2017-02-04,2,2,18,4
air_ef789667e2e6fe96,hpg_f76ad2d2d0134bdd,2017-02-05,2,2,69,4
air_ef789667e2e6fe96,hpg_f76ad2d2d0134bdd,2017-02-07,1,1,31,2
air_ef789667e2e6fe96,hpg_f76ad2d2d0134bdd,2017-02-11,16,18,38,34
air_ef789667e2e6fe96,hpg_f76ad2d2d0134bdd,2017-02-12,4,8,56,12
air_ef789667e2e6fe96,hpg_f76ad2d2d0134bdd,2017-02-14,3,3,14,6
air_ef789667e2e6fe96,hpg_f76ad2d2d0134bdd,2017-02-17,9,9,28,18
air_ef789667e2e6fe96,hpg_f76ad2d2d0134bdd,2017-02-18,2,2,59,4
air_ef789667e2e6fe96,hpg_f76ad2d2d0134bdd,2017-02-20,2,2,13,4
air_ef789667e2e6fe96,hpg_f76ad2d2d0134bdd,2017-02-25,18,18,61,36
air_ef789667e2e6fe96,hpg_f76ad2d2d0134bdd,2017-02-26,3,3,48,6
air_ef789667e2e6fe96,hpg_f76ad2d2d0134bdd,2017-02-28,2,2,23,4
air_ef789667e2e6fe96,hpg_f76ad2d2d0134bdd,2017-03-01,5,5,39,10
air_ef789667e2e6fe96,hpg_f76ad2d2d0134bdd,2017-03-02,6,6,18,12
air_ef789667e2e6fe96,hpg_f76ad2d2d0134bdd,2017-03-04,29,28,72,57
air_ef789667e2e6fe96,hpg_f76ad2d2d0134bdd,2017-03-07,2,2,28,4
air_ef789667e2e6fe96,hpg_f76ad2d2d0134bdd,2017-03-09,20,20,32,40
air_ef789667e2e6fe96,hpg_f76ad2d2d0134bdd,2017-03-15,2,2,19,4
air_ef789667e2e6fe96,hpg_f76ad2d2d0134bdd,2017-03-17,12,12,44,24
air_ef789667e2e6fe96,hpg_f76ad2d2d0134bdd,2017-03-18,7,38,49,45
air_ef789667e2e6fe96,hpg_f76ad2d2d0134bdd,2017-03-19,4,4,85,8
air_ef789667e2e6fe96,hpg_f76ad2d2d0134bdd,2017-03-21,2,2,15,4
air_ef789667e2e6fe96,hpg_f76ad2d2d0134bdd,2017-03-22,10,10,29,20
air_ef789667e2e6fe96,hpg_f76ad2d2d0134bdd,2017-03-23,2,27,13,29
air_ef789667e2e6fe96,hpg_f76ad2d2d0134bdd,2017-03-25,20,20,65,40
air_ef789667e2e6fe96,hpg_f76ad2d2d0134bdd,2017-03-28,9,9,49,18
air_ef789667e2e6fe96,hpg_f76ad2d2d0134bdd,2017-03-29,7,7,42,14
air_ef789667e2e6fe96,hpg_f76ad2d2d0134bdd,2017-03-30,16,16,49,32
air_ef789667e2e6fe96,hpg_f76ad2d2d0134bdd,2017-03-31,3,9,51,12
air_ef789667e2e6fe96,hpg_f76ad2d2d0134bdd,2017-04-07,9,9,36,18
air_ef789667e2e6fe96,hpg_f76ad2d2d0134bdd,2017-04-08,12,12,47,24
air_ef789667e2e6fe96,hpg_f76ad2d2d0134bdd,2017-04-09,10,10,74,20
air_ef789667e2e6fe96,hpg_f76ad2d2d0134bdd,2017-04-14,7,7,47,14
air_ef789667e2e6fe96,hpg_f76ad2d2d0134bdd,2017-04-15,2,2,66,4
air_ef789667e2e6fe96,hpg_f76ad2d2d0134bdd,2017-04-19,2,2,42,4
air_ef789667e2e6fe96,hpg_f76ad2d2d0134bdd,2017-04-21,8,8,48,16
air_ef789667e2e6fe96,hpg_f76ad2d2d0134bdd,2017-04-22,11,10,63,21
air_900d755ebd2f7bbd,hpg_2864fa16b03e3813,2017-04-01,9,2,47,11
air_900d755ebd2f7bbd,hpg_2864fa16b03e3813,2017-04-08,39,14,67,53
air_84f6876ff7e83ae7,hpg_0f78ef8d1e4b23d8,2016-10-27,11,3,23,14
air_84f6876ff7e83ae7,hpg_0f78ef8d1e4b23d8,2016-10-28,16,2,37,18
air_84f6876ff7e83ae7,hpg_0f78ef8d1e4b23d8,2016-10-29,11,6,18,17
air_84f6876ff7e83ae7,hpg_0f78ef8d1e4b23d8,2016-10-30,12,4,32,16
air_84f6876ff7e83ae7,hpg_0f78ef8d1e4b23d8,2016-11-01,9,5,22,14
air_84f6876ff7e83ae7,hpg_0f78ef8d1e4b23d8,2016-11-02,19,2,31,21
air_84f6876ff7e83ae7,hpg_0f78ef8d1e4b23d8,2016-11-05,14,4,24,18
air_84f6876ff7e83ae7,hpg_0f78ef8d1e4b23d8,2016-11-19,15,2,34,17
air_84f6876ff7e83ae7,hpg_0f78ef8d1e4b23d8,2016-11-22,19,4,35,23
air_84f6876ff7e83ae7,hpg_0f78ef8d1e4b23d8,2016-11-23,11,4,19,15
air_84f6876ff7e83ae7,hpg_0f78ef8d1e4b23d8,2016-11-25,12,4,19,16
air_84f6876ff7e83ae7,hpg_0f78ef8d1e4b23d8,2016-11-29,7,4,13,11
air_84f6876ff7e83ae7,hpg_0f78ef8d1e4b23d8,2016-12-06,5,5,11,10
air_84f6876ff7e83ae7,hpg_0f78ef8d1e4b23d8,2016-12-10,26,2,40,28
air_84f6876ff7e83ae7,hpg_0f78ef8d1e4b23d8,2016-12-14,13,3,15,16
air_84f6876ff7e83ae7,hpg_0f78ef8d1e4b23d8,2016-12-17,14,7,24,21
air_84f6876ff7e83ae7,hpg_0f78ef8d1e4b23d8,2016-12-20,5,3,18,8
air_84f6876ff7e83ae7,hpg_0f78ef8d1e4b23d8,2016-12-21,12,8,22,20
air_84f6876ff7e83ae7,hpg_0f78ef8d1e4b23d8,2016-12-22,25,4,34,29
air_84f6876ff7e83ae7,hpg_0f78ef8d1e4b23d8,2016-12-23,14,2,27,16
air_84f6876ff7e83ae7,hpg_0f78ef8d1e4b23d8,2016-12-24,22,2,30,24
air_84f6876ff7e83ae7,hpg_0f78ef8d1e4b23d8,2016-12-27,24,8,30,32
air_84f6876ff7e83ae7,hpg_0f78ef8d1e4b23d8,2016-12-28,19,2,34,21
air_84f6876ff7e83ae7,hpg_0f78ef8d1e4b23d8,2016-12-29,8,2,29,10
air_84f6876ff7e83ae7,hpg_0f78ef8d1e4b23d8,2016-12-30,23,3,30,26
air_84f6876ff7e83ae7,hpg_0f78ef8d1e4b23d8,2017-01-06,5,2,14,7
air_84f6876ff7e83ae7,hpg_0f78ef8d1e4b23d8,2017-01-20,17,2,30,19
air_84f6876ff7e83ae7,hpg_0f78ef8d1e4b23d8,2017-01-21,20,6,25,26
air_84f6876ff7e83ae7,hpg_0f78ef8d1e4b23d8,2017-01-22,14,2,18,16
air_84f6876ff7e83ae7,hpg_0f78ef8d1e4b23d8,2017-01-27,13,2,27,15
air_84f6876ff7e83ae7,hpg_0f78ef8d1e4b23d8,2017-02-08,23,2,24,25
air_84f6876ff7e83ae7,hpg_0f78ef8d1e4b23d8,2017-02-11,26,11,30,37
air_84f6876ff7e83ae7,hpg_0f78ef8d1e4b23d8,2017-02-17,31,2,42,33
air_84f6876ff7e83ae7,hpg_0f78ef8d1e4b23d8,2017-02-18,19,2,25,21
air_84f6876ff7e83ae7,hpg_0f78ef8d1e4b23d8,2017-02-21,5,5,11,10
air_84f6876ff7e83ae7,hpg_0f78ef8d1e4b23d8,2017-02-24,22,3,27,25
air_84f6876ff7e83ae7,hpg_0f78ef8d1e4b23d8,2017-02-25,16,7,24,23
air_84f6876ff7e83ae7,hpg_0f78ef8d1e4b23d8,2017-02-28,2,4,13,6
air_84f6876ff7e83ae7,hpg_0f78ef8d1e4b23d8,2017-03-03,27,4,37,31
air_84f6876ff7e83ae7,hpg_0f78ef8d1e4b23d8,2017-03-04,15,5,34,20
air_84f6876ff7e83ae7,hpg_0f78ef8d1e4b23d8,2017-03-05,17,2,35,19
air_84f6876ff7e83ae7,hpg_0f78ef8d1e4b23d8,2017-03-07,8,3,22,11
air_84f6876ff7e83ae7,hpg_0f78ef8d1e4b23d8,2017-03-10,8,7,35,15
air_84f6876ff7e83ae7,hpg_0f78ef8d1e4b23d8,2017-03-15,23,4,33,27
air_84f6876ff7e83ae7,hpg_0f78ef8d1e4b23d8,2017-03-17,11,2,23,13
air_84f6876ff7e83ae7,hpg_0f78ef8d1e4b23d8,2017-03-18,14,6,33,20
air_84f6876ff7e83ae7,hpg_0f78ef8d1e4b23d8,2017-03-19,12,6,40,18
air_84f6876ff7e83ae7,hpg_0f78ef8d1e4b23d8,2017-03-20,15,2,22,17
air_84f6876ff7e83ae7,hpg_0f78ef8d1e4b23d8,2017-03-23,4,2,13,6
air_84f6876ff7e83ae7,hpg_0f78ef8d1e4b23d8,2017-03-24,22,2,24,24
air_84f6876ff7e83ae7,hpg_0f78ef8d1e4b23d8,2017-03-25,2,3,29,5
air_84f6876ff7e83ae7,hpg_0f78ef8d1e4b23d8,2017-03-26,15,5,18,20
air_84f6876ff7e83ae7,hpg_0f78ef8d1e4b23d8,2017-03-28,5,3,18,8
air_84f6876ff7e83ae7,hpg_0f78ef8d1e4b23d8,2017-04-01,14,6,26,20
air_84f6876ff7e83ae7,hpg_0f78ef8d1e4b23d8,2017-04-02,14,2,29,16
air_84f6876ff7e83ae7,hpg_0f78ef8d1e4b23d8,2017-04-08,15,7,20,22
air_8e492076a1179383,hpg_aee92538e1b51d5f,2016-11-09,20,2,64,22
air_8e492076a1179383,hpg_aee92538e1b51d5f,2017-01-02,97,2,199,99
air_8e492076a1179383,hpg_aee92538e1b51d5f,2017-01-25,6,3,35,9
air_54ed43163b7596c4,hpg_583dddac1a035048,2016-01-09,5,5,5,10
air_54ed43163b7596c4,hpg_583dddac1a035048,2016-01-15,10,8,22,18
air_54ed43163b7596c4,hpg_583dddac1a035048,2016-01-21,17,13,17,30
air_54ed43163b7596c4,hpg_583dddac1a035048,2016-01-22,15,4,19,19
air_54ed43163b7596c4,hpg_583dddac1a035048,2016-01-27,19,6,19,25
air_54ed43163b7596c4,hpg_583dddac1a035048,2016-01-29,9,3,21,12
air_54ed43163b7596c4,hpg_583dddac1a035048,2016-02-04,19,7,23,26
air_54ed43163b7596c4,hpg_583dddac1a035048,2016-02-05,21,11,26,32
air_54ed43163b7596c4,hpg_583dddac1a035048,2016-02-16,17,15,19,32
air_54ed43163b7596c4,hpg_583dddac1a035048,2016-02-19,20,3,22,23
air_54ed43163b7596c4,hpg_583dddac1a035048,2016-02-23,17,5,18,22
air_54ed43163b7596c4,hpg_583dddac1a035048,2016-02-24,16,10,24,26
air_54ed43163b7596c4,hpg_583dddac1a035048,2016-02-25,17,2,17,19
air_54ed43163b7596c4,hpg_583dddac1a035048,2016-02-26,17,6,20,23
air_54ed43163b7596c4,hpg_583dddac1a035048,2016-03-02,18,16,22,34
air_54ed43163b7596c4,hpg_583dddac1a035048,2016-03-03,12,5,17,17
air_54ed43163b7596c4,hpg_583dddac1a035048,2016-03-04,17,5,21,22
air_54ed43163b7596c4,hpg_583dddac1a035048,2016-03-15,14,18,14,32
air_54ed43163b7596c4,hpg_583dddac1a035048,2016-03-22,20,29,20,49
air_54ed43163b7596c4,hpg_583dddac1a035048,2016-03-28,13,8,18,21
air_54ed43163b7596c4,hpg_583dddac1a035048,2016-03-29,4,3,17,7
air_54ed43163b7596c4,hpg_583dddac1a035048,2016-03-31,22,5,22,27
air_54ed43163b7596c4,hpg_583dddac1a035048,2016-04-11,13,13,18,26
air_54ed43163b7596c4,hpg_583dddac1a035048,2016-04-14,15,26,18,41
air_54ed43163b7596c4,hpg_583dddac1a035048,2016-04-21,18,13,18,31
air_54ed43163b7596c4,hpg_583dddac1a035048,2016-04-22,22,21,22,43
air_54ed43163b7596c4,hpg_583dddac1a035048,2016-05-10,6,3,6,9
air_54ed43163b7596c4,hpg_583dddac1a035048,2016-05-19,8,12,17,20
air_54ed43163b7596c4,hpg_583dddac1a035048,2016-05-20,19,13,19,32
air_54ed43163b7596c4,hpg_583dddac1a035048,2016-05-24,6,2,17,8
air_54ed43163b7596c4,hpg_583dddac1a035048,2016-06-10,19,12,19,31
air_54ed43163b7596c4,hpg_583dddac1a035048,2016-11-08,4,4,15,8
air_54ed43163b7596c4,hpg_583dddac1a035048,2016-11-10,7,3,7,10
air_54ed43163b7596c4,hpg_583dddac1a035048,2016-11-16,7,2,11,9
air_54ed43163b7596c4,hpg_583dddac1a035048,2016-11-17,17,20,17,37
air_54ed43163b7596c4,hpg_583dddac1a035048,2016-11-18,12,5,12,17
air_54ed43163b7596c4,hpg_583dddac1a035048,2016-11-24,7,12,20,19
air_54ed43163b7596c4,hpg_583dddac1a035048,2016-11-25,17,20,21,37
air_54ed43163b7596c4,hpg_583dddac1a035048,2016-11-29,18,4,22,22
air_54ed43163b7596c4,hpg_583dddac1a035048,2016-12-02,16,5,27,21
air_54ed43163b7596c4,hpg_583dddac1a035048,2016-12-05,16,4,20,20
air_54ed43163b7596c4,hpg_583dddac1a035048,2016-12-06,11,2,16,13
air_54ed43163b7596c4,hpg_583dddac1a035048,2016-12-13,13,4,15,17
air_54ed43163b7596c4,hpg_583dddac1a035048,2016-12-15,11,3,17,14
air_54ed43163b7596c4,hpg_583dddac1a035048,2016-12-16,22,23,27,45
air_54ed43163b7596c4,hpg_583dddac1a035048,2016-12-21,15,4,24,19
air_54ed43163b7596c4,hpg_583dddac1a035048,2016-12-26,22,29,30,51
air_54ed43163b7596c4,hpg_583dddac1a035048,2017-01-12,4,4,15,8
air_54ed43163b7596c4,hpg_583dddac1a035048,2017-01-13,13,15,22,28
air_54ed43163b7596c4,hpg_583dddac1a035048,2017-01-27,11,6,17,17
air_54ed43163b7596c4,hpg_583dddac1a035048,2017-01-31,17,17,17,34
air_54ed43163b7596c4,hpg_583dddac1a035048,2017-02-03,20,15,22,35
air_54ed43163b7596c4,hpg_583dddac1a035048,2017-02-17,2,2,9,4
air_54ed43163b7596c4,hpg_583dddac1a035048,2017-02-21,13,3,20,16
air_54ed43163b7596c4,hpg_583dddac1a035048,2017-02-24,6,6,19,12
air_54ed43163b7596c4,hpg_583dddac1a035048,2017-02-25,12,25,17,37
air_54ed43163b7596c4,hpg_583dddac1a035048,2017-02-28,19,9,19,28
air_54ed43163b7596c4,hpg_583dddac1a035048,2017-03-10,8,4,17,12
air_54ed43163b7596c4,hpg_583dddac1a035048,2017-03-14,10,10,16,20
air_54ed43163b7596c4,hpg_583dddac1a035048,2017-03-15,12,4,22,16
air_54ed43163b7596c4,hpg_583dddac1a035048,2017-03-16,8,7,8,15
air_54ed43163b7596c4,hpg_583dddac1a035048,2017-03-17,16,4,24,20
air_54ed43163b7596c4,hpg_583dddac1a035048,2017-03-22,21,4,28,25
air_54ed43163b7596c4,hpg_583dddac1a035048,2017-03-30,12,6,17,18
air_54ed43163b7596c4,hpg_583dddac1a035048,2017-04-04,6,6,20,12
air_54ed43163b7596c4,hpg_583dddac1a035048,2017-04-07,19,4,22,23
air_ccd19a5bc5573ae5,hpg_df22bf146d2c7e19,2016-11-11,4,2,18,6
air_ccd19a5bc5573ae5,hpg_df22bf146d2c7e19,2016-11-13,5,2,48,7
air_ccd19a5bc5573ae5,hpg_df22bf146d2c7e19,2016-11-22,21,2,44,23
air_ccd19a5bc5573ae5,hpg_df22bf146d2c7e19,2016-11-30,16,2,37,18
air_ccd19a5bc5573ae5,hpg_df22bf146d2c7e19,2016-12-02,23,4,48,27
air_ccd19a5bc5573ae5,hpg_df22bf146d2c7e19,2016-12-04,2,2,38,4
air_ccd19a5bc5573ae5,hpg_df22bf146d2c7e19,2016-12-05,2,2,10,4
air_ccd19a5bc5573ae5,hpg_df22bf146d2c7e19,2016-12-09,13,5,43,18
air_ccd19a5bc5573ae5,hpg_df22bf146d2c7e19,2016-12-12,4,2,17,6
air_ccd19a5bc5573ae5,hpg_df22bf146d2c7e19,2016-12-19,4,2,20,6
air_ccd19a5bc5573ae5,hpg_df22bf146d2c7e19,2016-12-22,27,2,46,29
air_ccd19a5bc5573ae5,hpg_df22bf146d2c7e19,2016-12-23,10,2,64,12
air_ccd19a5bc5573ae5,hpg_df22bf146d2c7e19,2016-12-24,14,6,62,20
air_ccd19a5bc5573ae5,hpg_df22bf146d2c7e19,2016-12-26,16,8,31,24
air_ccd19a5bc5573ae5,hpg_df22bf146d2c7e19,2016-12-27,19,3,48,22
air_ccd19a5bc5573ae5,hpg_df22bf146d2c7e19,2017-01-05,7,2,19,9
air_ccd19a5bc5573ae5,hpg_df22bf146d2c7e19,2017-01-07,4,2,64,6
air_ccd19a5bc5573ae5,hpg_df22bf146d2c7e19,2017-01-13,2,4,28,6
air_ccd19a5bc5573ae5,hpg_df22bf146d2c7e19,2017-01-20,27,2,53,29
air_ccd19a5bc5573ae5,hpg_df22bf146d2c7e19,2017-01-25,4,2,33,6
air_ccd19a5bc5573ae5,hpg_df22bf146d2c7e19,2017-02-07,6,2,23,8
air_ccd19a5bc5573ae5,hpg_df22bf146d2c7e19,2017-02-15,8,4,19,12
air_ccd19a5bc5573ae5,hpg_df22bf146d2c7e19,2017-02-21,7,2,13,9
air_ccd19a5bc5573ae5,hpg_df22bf146d2c7e19,2017-02-27,10,2,15,12
air_ccd19a5bc5573ae5,hpg_df22bf146d2c7e19,2017-03-04,10,2,69,12
air_ccd19a5bc5573ae5,hpg_df22bf146d2c7e19,2017-03-05,15,2,71,17
air_ccd19a5bc5573ae5,hpg_df22bf146d2c7e19,2017-03-11,12,6,83,18
air_ccd19a5bc5573ae5,hpg_df22bf146d2c7e19,2017-03-21,7,8,25,15
air_ccd19a5bc5573ae5,hpg_df22bf146d2c7e19,2017-03-26,21,3,47,24
air_ccd19a5bc5573ae5,hpg_df22bf146d2c7e19,2017-04-06,4,2,10,6
air_ccd19a5bc5573ae5,hpg_df22bf146d2c7e19,2017-04-14,14,7,62,21
air_ccd19a5bc5573ae5,hpg_df22bf146d2c7e19,2017-04-15,13,3,103,16
air_ccd19a5bc5573ae5,hpg_df22bf146d2c7e19,2017-04-18,3,3,21,6
air_ccd19a5bc5573ae5,hpg_df22bf146d2c7e19,2017-04-21,11,12,53,23
air_bebd55ed63ab2422,hpg_5014838c16a831ad,2016-10-31,8,2,6,10
air_bebd55ed63ab2422,hpg_5014838c16a831ad,2016-11-05,4,2,9,6
air_bebd55ed63ab2422,hpg_5014838c16a831ad,2016-11-12,19,4,25,23
air_bebd55ed63ab2422,hpg_5014838c16a831ad,2016-11-19,10,4,20,14
air_bebd55ed63ab2422,hpg_5014838c16a831ad,2016-11-25,2,2,4,4
air_bebd55ed63ab2422,hpg_5014838c16a831ad,2016-11-26,9,4,18,13
air_bebd55ed63ab2422,hpg_5014838c16a831ad,2016-12-03,10,6,7,16
air_bebd55ed63ab2422,hpg_5014838c16a831ad,2016-12-10,8,2,11,10
air_bebd55ed63ab2422,hpg_5014838c16a831ad,2016-12-17,11,5,10,16
air_bebd55ed63ab2422,hpg_5014838c16a831ad,2016-12-18,22,4,29,26
air_bebd55ed63ab2422,hpg_5014838c16a831ad,2016-12-19,2,2,15,4
air_bebd55ed63ab2422,hpg_5014838c16a831ad,2016-12-21,4,4,11,8
air_bebd55ed63ab2422,hpg_5014838c16a831ad,2016-12-23,8,11,18,19
air_bebd55ed63ab2422,hpg_5014838c16a831ad,2016-12-24,14,5,16,19
air_bebd55ed63ab2422,hpg_5014838c16a831ad,2016-12-25,11,4,18,15
air_bebd55ed63ab2422,hpg_5014838c16a831ad,2016-12-29,9,6,16,15
air_bebd55ed63ab2422,hpg_5014838c16a831ad,2016-12-31,4,4,4,8
air_bebd55ed63ab2422,hpg_5014838c16a831ad,2017-01-01,8,6,30,14
air_bebd55ed63ab2422,hpg_5014838c16a831ad,2017-01-03,7,7,7,14
air_bebd55ed63ab2422,hpg_5014838c16a831ad,2017-01-07,2,2,9,4
air_bebd55ed63ab2422,hpg_5014838c16a831ad,2017-01-08,4,4,6,8
air_bebd55ed63ab2422,hpg_5014838c16a831ad,2017-01-14,2,2,3,4
air_bebd55ed63ab2422,hpg_5014838c16a831ad,2017-01-15,5,5,11,10
air_bebd55ed63ab2422,hpg_5014838c16a831ad,2017-01-16,2,2,11,4
air_bebd55ed63ab2422,hpg_5014838c16a831ad,2017-01-28,5,5,18,10
air_bebd55ed63ab2422,hpg_5014838c16a831ad,2017-02-04,4,2,9,6
air_bebd55ed63ab2422,hpg_5014838c16a831ad,2017-02-09,2,2,5,4
air_bebd55ed63ab2422,hpg_5014838c16a831ad,2017-02-16,2,2,8,4
air_bebd55ed63ab2422,hpg_5014838c16a831ad,2017-02-17,6,2,2,8
air_bebd55ed63ab2422,hpg_5014838c16a831ad,2017-02-18,4,4,15,8
air_bebd55ed63ab2422,hpg_5014838c16a831ad,2017-02-25,6,6,10,12
air_bebd55ed63ab2422,hpg_5014838c16a831ad,2017-03-07,5,5,11,10
air_bebd55ed63ab2422,hpg_5014838c16a831ad,2017-03-18,10,2,8,12
air_bebd55ed63ab2422,hpg_5014838c16a831ad,2017-03-19,4,4,10,8
air_bebd55ed63ab2422,hpg_5014838c16a831ad,2017-03-26,8,8,18,16
air_bebd55ed63ab2422,hpg_5014838c16a831ad,2017-03-28,4,9,5,13
air_bebd55ed63ab2422,hpg_5014838c16a831ad,2017-03-30,5,5,8,10
air_bebd55ed63ab2422,hpg_5014838c16a831ad,2017-04-07,2,2,2,4
air_bebd55ed63ab2422,hpg_5014838c16a831ad,2017-04-08,4,4,8,8
air_4cca5666eaf5c709,hpg_f83413cde79ac5e7,2016-01-19,9,4,29,13
air_4cca5666eaf5c709,hpg_f83413cde79ac5e7,2016-02-05,5,3,31,8
air_4cca5666eaf5c709,hpg_f83413cde79ac5e7,2016-02-28,7,3,42,10
air_4cca5666eaf5c709,hpg_f83413cde79ac5e7,2016-03-05,3,6,37,9
air_4cca5666eaf5c709,hpg_f83413cde79ac5e7,2016-04-08,3,3,41,6
air_4cca5666eaf5c709,hpg_f83413cde79ac5e7,2016-11-20,8,8,44,16
air_4cca5666eaf5c709,hpg_f83413cde79ac5e7,2016-12-26,6,4,17,10
air_4cca5666eaf5c709,hpg_f83413cde79ac5e7,2017-01-21,11,8,36,19
air_4cca5666eaf5c709,hpg_f83413cde79ac5e7,2017-02-02,3,6,30,9
air_4cca5666eaf5c709,hpg_f83413cde79ac5e7,2017-02-10,2,7,28,9
air_4cca5666eaf5c709,hpg_f83413cde79ac5e7,2017-04-22,2,2,34,4
air_42c9aa6d617c5057,hpg_053676b196ae1e1e,2016-10-28,20,9,49,29
air_42c9aa6d617c5057,hpg_053676b196ae1e1e,2016-10-29,17,13,59,30
air_42c9aa6d617c5057,hpg_053676b196ae1e1e,2016-11-02,12,2,33,14
air_42c9aa6d617c5057,hpg_053676b196ae1e1e,2016-11-05,13,10,46,23
air_42c9aa6d617c5057,hpg_053676b196ae1e1e,2016-11-06,9,2,33,11
air_42c9aa6d617c5057,hpg_053676b196ae1e1e,2016-11-09,13,10,48,23
air_42c9aa6d617c5057,hpg_053676b196ae1e1e,2016-11-10,21,7,41,28
air_42c9aa6d617c5057,hpg_053676b196ae1e1e,2016-11-11,6,2,33,8
air_42c9aa6d617c5057,hpg_053676b196ae1e1e,2016-11-12,20,7,41,27
air_42c9aa6d617c5057,hpg_053676b196ae1e1e,2016-11-13,14,4,67,18
air_42c9aa6d617c5057,hpg_053676b196ae1e1e,2016-11-14,12,5,38,17
air_42c9aa6d617c5057,hpg_053676b196ae1e1e,2016-11-17,6,2,38,8
air_42c9aa6d617c5057,hpg_053676b196ae1e1e,2016-11-18,6,4,40,10
air_42c9aa6d617c5057,hpg_053676b196ae1e1e,2016-11-19,21,12,65,33
air_42c9aa6d617c5057,hpg_053676b196ae1e1e,2016-11-20,8,4,38,12
air_42c9aa6d617c5057,hpg_053676b196ae1e1e,2016-11-21,9,5,38,14
air_42c9aa6d617c5057,hpg_053676b196ae1e1e,2016-11-24,5,2,26,7
air_42c9aa6d617c5057,hpg_053676b196ae1e1e,2016-11-25,2,2,49,4
air_42c9aa6d617c5057,hpg_053676b196ae1e1e,2016-11-26,22,8,69,30
air_42c9aa6d617c5057,hpg_053676b196ae1e1e,2016-11-27,26,10,58,36
air_42c9aa6d617c5057,hpg_053676b196ae1e1e,2016-11-28,21,2,52,23
air_42c9aa6d617c5057,hpg_053676b196ae1e1e,2016-11-30,13,7,46,20
air_42c9aa6d617c5057,hpg_053676b196ae1e1e,2016-12-02,20,9,46,29
air_42c9aa6d617c5057,hpg_053676b196ae1e1e,2016-12-03,19,2,46,21
air_42c9aa6d617c5057,hpg_053676b196ae1e1e,2016-12-04,18,2,62,20
air_42c9aa6d617c5057,hpg_053676b196ae1e1e,2016-12-07,12,4,46,16
air_42c9aa6d617c5057,hpg_053676b196ae1e1e,2016-12-08,17,3,30,20
air_42c9aa6d617c5057,hpg_053676b196ae1e1e,2016-12-10,16,12,52,28
air_42c9aa6d617c5057,hpg_053676b196ae1e1e,2016-12-11,9,2,39,11
air_42c9aa6d617c5057,hpg_053676b196ae1e1e,2016-12-12,7,5,41,12
air_42c9aa6d617c5057,hpg_053676b196ae1e1e,2016-12-14,11,2,30,13
air_42c9aa6d617c5057,hpg_053676b196ae1e1e,2016-12-15,16,9,40,25
air_42c9aa6d617c5057,hpg_053676b196ae1e1e,2016-12-17,36,9,56,45
air_42c9aa6d617c5057,hpg_053676b196ae1e1e,2016-12-18,24,20,61,44
air_42c9aa6d617c5057,hpg_053676b196ae1e1e,2016-12-19,15,6,41,21
air_42c9aa6d617c5057,hpg_053676b196ae1e1e,2016-12-22,27,2,48,29
air_42c9aa6d617c5057,hpg_053676b196ae1e1e,2016-12-23,14,4,27,18
air_42c9aa6d617c5057,hpg_053676b196ae1e1e,2016-12-24,23,2,70,25
air_42c9aa6d617c5057,hpg_053676b196ae1e1e,2016-12-25,37,12,71,49
air_42c9aa6d617c5057,hpg_053676b196ae1e1e,2016-12-26,26,4,41,30
air_42c9aa6d617c5057,hpg_053676b196ae1e1e,2016-12-28,21,14,48,35
air_42c9aa6d617c5057,hpg_053676b196ae1e1e,2016-12-29,40,13,80,53
air_42c9aa6d617c5057,hpg_053676b196ae1e1e,2016-12-30,25,10,63,35
air_42c9aa6d617c5057,hpg_053676b196ae1e1e,2016-12-31,16,8,46,24
air_42c9aa6d617c5057,hpg_053676b196ae1e1e,2017-01-01,12,2,36,14
air_42c9aa6d617c5057,hpg_053676b196ae1e1e,2017-01-03,29,8,62,37
air_42c9aa6d617c5057,hpg_053676b196ae1e1e,2017-01-06,23,12,53,35
air_42c9aa6d617c5057,hpg_053676b196ae1e1e,2017-01-07,21,5,41,26
air_42c9aa6d617c5057,hpg_053676b196ae1e1e,2017-01-08,11,2,47,13
air_42c9aa6d617c5057,hpg_053676b196ae1e1e,2017-01-09,15,4,49,19
air_42c9aa6d617c5057,hpg_053676b196ae1e1e,2017-01-11,16,8,37,24
air_42c9aa6d617c5057,hpg_053676b196ae1e1e,2017-01-12,7,5,24,12
air_42c9aa6d617c5057,hpg_053676b196ae1e1e,2017-01-13,10,6,37,16
air_42c9aa6d617c5057,hpg_053676b196ae1e1e,2017-01-14,18,16,39,34
air_42c9aa6d617c5057,hpg_053676b196ae1e1e,2017-01-15,8,4,32,12
air_42c9aa6d617c5057,hpg_053676b196ae1e1e,2017-01-16,11,4,28,15
air_42c9aa6d617c5057,hpg_053676b196ae1e1e,2017-01-20,25,8,46,33
air_42c9aa6d617c5057,hpg_053676b196ae1e1e,2017-01-21,4,4,42,8
air_42c9aa6d617c5057,hpg_053676b196ae1e1e,2017-01-22,16,7,32,23
air_42c9aa6d617c5057,hpg_053676b196ae1e1e,2017-01-25,15,14,38,29
air_42c9aa6d617c5057,hpg_053676b196ae1e1e,2017-01-26,10,3,39,13
air_42c9aa6d617c5057,hpg_053676b196ae1e1e,2017-01-27,16,2,49,18
air_42c9aa6d617c5057,hpg_053676b196ae1e1e,2017-01-28,18,4,46,22
air_42c9aa6d617c5057,hpg_053676b196ae1e1e,2017-01-29,23,8,38,31
air_42c9aa6d617c5057,hpg_053676b196ae1e1e,2017-02-01,9,2,42,11
air_42c9aa6d617c5057,hpg_053676b196ae1e1e,2017-02-04,25,10,61,35
air_42c9aa6d617c5057,hpg_053676b196ae1e1e,2017-02-05,13,5,55,18
air_42c9aa6d617c5057,hpg_053676b196ae1e1e,2017-02-06,9,4,32,13
air_42c9aa6d617c5057,hpg_053676b196ae1e1e,2017-02-08,9,9,32,18
air_42c9aa6d617c5057,hpg_053676b196ae1e1e,2017-02-09,14,7,36,21
air_42c9aa6d617c5057,hpg_053676b196ae1e1e,2017-02-10,12,11,36,23
air_42c9aa6d617c5057,hpg_053676b196ae1e1e,2017-02-11,21,2,55,23
air_42c9aa6d617c5057,hpg_053676b196ae1e1e,2017-02-12,9,15,61,24
air_42c9aa6d617c5057,hpg_053676b196ae1e1e,2017-02-15,12,6,42,18
air_42c9aa6d617c5057,hpg_053676b196ae1e1e,2017-02-16,27,7,46,34
air_42c9aa6d617c5057,hpg_053676b196ae1e1e,2017-02-17,18,10,48,28
air_42c9aa6d617c5057,hpg_053676b196ae1e1e,2017-02-18,24,6,70,30
air_42c9aa6d617c5057,hpg_053676b196ae1e1e,2017-02-19,40,9,58,49
air_42c9aa6d617c5057,hpg_053676b196ae1e1e,2017-02-20,6,2,25,8
air_42c9aa6d617c5057,hpg_053676b196ae1e1e,2017-02-22,4,3,38,7
air_42c9aa6d617c5057,hpg_053676b196ae1e1e,2017-02-23,10,6,36,16
air_42c9aa6d617c5057,hpg_053676b196ae1e1e,2017-02-24,11,5,39,16
air_42c9aa6d617c5057,hpg_053676b196ae1e1e,2017-02-25,30,15,67,45
air_42c9aa6d617c5057,hpg_053676b196ae1e1e,2017-02-26,19,12,62,31
air_42c9aa6d617c5057,hpg_053676b196ae1e1e,2017-02-27,10,2,38,12
air_42c9aa6d617c5057,hpg_053676b196ae1e1e,2017-03-01,12,10,32,22
air_42c9aa6d617c5057,hpg_053676b196ae1e1e,2017-03-02,8,3,34,11
air_42c9aa6d617c5057,hpg_053676b196ae1e1e,2017-03-03,12,9,37,21
air_42c9aa6d617c5057,hpg_053676b196ae1e1e,2017-03-04,14,4,39,18
air_42c9aa6d617c5057,hpg_053676b196ae1e1e,2017-03-05,20,7,55,27
air_42c9aa6d617c5057,hpg_053676b196ae1e1e,2017-03-06,10,2,35,12
air_42c9aa6d617c5057,hpg_053676b196ae1e1e,2017-03-08,16,11,48,27
air_42c9aa6d617c5057,hpg_053676b196ae1e1e,2017-03-09,12,8,46,20
air_42c9aa6d617c5057,hpg_053676b196ae1e1e,2017-03-10,31,25,62,56
air_42c9aa6d617c5057,hpg_053676b196ae1e1e,2017-03-11,46,11,85,57
air_42c9aa6d617c5057,hpg_053676b196ae1e1e,2017-03-12,33,18,84,51
air_42c9aa6d617c5057,hpg_053676b196ae1e1e,2017-03-13,11,4,38,15
air_42c9aa6d617c5057,hpg_053676b196ae1e1e,2017-03-15,8,5,39,13
air_42c9aa6d617c5057,hpg_053676b196ae1e1e,2017-03-16,14,5,57,19
air_42c9aa6d617c5057,hpg_053676b196ae1e1e,2017-03-17,9,6,30,15
air_42c9aa6d617c5057,hpg_053676b196ae1e1e,2017-03-18,26,13,46,39
air_42c9aa6d617c5057,hpg_053676b196ae1e1e,2017-03-20,29,10,70,39
air_42c9aa6d617c5057,hpg_053676b196ae1e1e,2017-03-22,5,2,29,7
air_42c9aa6d617c5057,hpg_053676b196ae1e1e,2017-03-23,9,6,29,15
air_42c9aa6d617c5057,hpg_053676b196ae1e1e,2017-03-24,21,5,41,26
air_42c9aa6d617c5057,hpg_053676b196ae1e1e,2017-03-25,17,7,56,24
air_42c9aa6d617c5057,hpg_053676b196ae1e1e,2017-03-26,33,3,61,36
air_42c9aa6d617c5057,hpg_053676b196ae1e1e,2017-03-29,18,2,42,20
air_42c9aa6d617c5057,hpg_053676b196ae1e1e,2017-03-30,18,9,37,27
air_42c9aa6d617c5057,hpg_053676b196ae1e1e,2017-03-31,23,6,51,29
air_42c9aa6d617c5057,hpg_053676b196ae1e1e,2017-04-01,20,2,58,22
air_42c9aa6d617c5057,hpg_053676b196ae1e1e,2017-04-06,6,2,32,8
air_42c9aa6d617c5057,hpg_053676b196ae1e1e,2017-04-07,11,11,28,22
air_42c9aa6d617c5057,hpg_053676b196ae1e1e,2017-04-08,8,8,47,16
air_42c9aa6d617c5057,hpg_053676b196ae1e1e,2017-04-09,32,21,60,53
air_42c9aa6d617c5057,hpg_053676b196ae1e1e,2017-04-10,2,5,22,7
air_42c9aa6d617c5057,hpg_053676b196ae1e1e,2017-04-12,2,2,37,4
air_42c9aa6d617c5057,hpg_053676b196ae1e1e,2017-04-13,8,3,33,11
air_42c9aa6d617c5057,hpg_053676b196ae1e1e,2017-04-14,18,4,42,22
air_42c9aa6d617c5057,hpg_053676b196ae1e1e,2017-04-15,25,12,59,37
air_42c9aa6d617c5057,hpg_053676b196ae1e1e,2017-04-16,26,14,64,40
air_42c9aa6d617c5057,hpg_053676b196ae1e1e,2017-04-17,16,12,42,28
air_42c9aa6d617c5057,hpg_053676b196ae1e1e,2017-04-19,22,9,41,31
air_42c9aa6d617c5057,hpg_053676b196ae1e1e,2017-04-20,7,3,35,10
air_42c9aa6d617c5057,hpg_053676b196ae1e1e,2017-04-21,21,15,40,36
air_42c9aa6d617c5057,hpg_053676b196ae1e1e,2017-04-22,23,4,48,27
air_6c91a28278a16f64,hpg_945c2807cef88022,2016-01-03,4,4,24,8
air_6c91a28278a16f64,hpg_945c2807cef88022,2016-01-10,3,6,27,9
air_6c91a28278a16f64,hpg_945c2807cef88022,2016-01-17,10,3,23,13
air_6c91a28278a16f64,hpg_945c2807cef88022,2016-01-20,2,2,11,4
air_6c91a28278a16f64,hpg_945c2807cef88022,2016-01-21,2,2,22,4
air_6c91a28278a16f64,hpg_945c2807cef88022,2016-01-22,7,4,8,11
air_6c91a28278a16f64,hpg_945c2807cef88022,2016-01-23,8,2,17,10
air_6c91a28278a16f64,hpg_945c2807cef88022,2016-01-24,2,2,21,4
air_6c91a28278a16f64,hpg_945c2807cef88022,2016-01-27,3,3,8,6
air_6c91a28278a16f64,hpg_945c2807cef88022,2016-01-29,6,2,9,8
air_6c91a28278a16f64,hpg_945c2807cef88022,2016-01-30,2,2,23,4
air_6c91a28278a16f64,hpg_945c2807cef88022,2016-01-31,4,6,35,10
air_6c91a28278a16f64,hpg_945c2807cef88022,2016-02-05,10,2,22,12
air_6c91a28278a16f64,hpg_945c2807cef88022,2016-02-06,9,5,25,14
air_6c91a28278a16f64,hpg_945c2807cef88022,2016-02-07,2,2,17,4
air_6c91a28278a16f64,hpg_945c2807cef88022,2016-02-12,6,6,10,12
air_6c91a28278a16f64,hpg_945c2807cef88022,2016-02-19,5,5,10,10
air_6c91a28278a16f64,hpg_945c2807cef88022,2016-02-20,6,3,26,9
air_6c91a28278a16f64,hpg_945c2807cef88022,2016-02-21,6,6,20,12
air_6c91a28278a16f64,hpg_945c2807cef88022,2016-02-22,2,2,12,4
air_6c91a28278a16f64,hpg_945c2807cef88022,2016-02-23,6,6,8,12
air_6c91a28278a16f64,hpg_945c2807cef88022,2016-02-26,3,3,21,6
air_6c91a28278a16f64,hpg_945c2807cef88022,2016-02-28,8,8,27,16
air_6c91a28278a16f64,hpg_945c2807cef88022,2016-03-09,2,2,11,4
air_6c91a28278a16f64,hpg_945c2807cef88022,2016-03-13,2,2,18,4
air_6c91a28278a16f64,hpg_945c2807cef88022,2016-03-16,2,2,10,4
air_6c91a28278a16f64,hpg_945c2807cef88022,2016-03-21,11,11,17,22
air_6c91a28278a16f64,hpg_945c2807cef88022,2016-03-25,13,6,22,19
air_6c91a28278a16f64,hpg_945c2807cef88022,2016-04-01,6,15,11,21
air_6c91a28278a16f64,hpg_945c2807cef88022,2016-04-05,6,6,10,12
air_6c91a28278a16f64,hpg_945c2807cef88022,2016-04-09,15,2,35,17
air_6c91a28278a16f64,hpg_945c2807cef88022,2016-04-10,3,3,29,6
air_6c91a28278a16f64,hpg_945c2807cef88022,2016-04-15,7,7,21,14
air_6c91a28278a16f64,hpg_945c2807cef88022,2016-04-20,6,6,14,12
air_6c91a28278a16f64,hpg_945c2807cef88022,2016-04-22,5,5,12,10
air_6c91a28278a16f64,hpg_945c2807cef88022,2016-04-24,8,6,31,14
air_6c91a28278a16f64,hpg_945c2807cef88022,2016-04-29,8,5,14,13
air_6c91a28278a16f64,hpg_945c2807cef88022,2016-05-06,2,2,6,4
air_6c91a28278a16f64,hpg_945c2807cef88022,2016-05-07,8,8,22,16
air_6c91a28278a16f64,hpg_945c2807cef88022,2016-05-11,2,2,7,4
air_6c91a28278a16f64,hpg_945c2807cef88022,2016-05-13,7,3,12,10
air_6c91a28278a16f64,hpg_945c2807cef88022,2016-05-18,2,2,3,4
air_6c91a28278a16f64,hpg_945c2807cef88022,2016-05-19,2,4,4,6
air_6c91a28278a16f64,hpg_945c2807cef88022,2016-05-20,3,3,8,6
air_6c91a28278a16f64,hpg_945c2807cef88022,2016-05-21,9,4,24,13
air_6c91a28278a16f64,hpg_945c2807cef88022,2016-05-22,6,2,22,8
air_6c91a28278a16f64,hpg_945c2807cef88022,2016-10-28,7,4,19,11
air_6c91a28278a16f64,hpg_945c2807cef88022,2016-11-02,2,2,3,4
air_6c91a28278a16f64,hpg_945c2807cef88022,2016-11-05,2,4,20,6
air_6c91a28278a16f64,hpg_945c2807cef88022,2016-11-06,2,2,5,4
air_6c91a28278a16f64,hpg_945c2807cef88022,2016-11-19,8,2,17,10
air_6c91a28278a16f64,hpg_945c2807cef88022,2016-11-22,5,3,9,8
air_6c91a28278a16f64,hpg_945c2807cef88022,2016-11-25,3,3,10,6
air_6c91a28278a16f64,hpg_945c2807cef88022,2016-11-26,11,5,23,16
air_6c91a28278a16f64,hpg_945c2807cef88022,2016-11-27,7,5,12,12
air_6c91a28278a16f64,hpg_945c2807cef88022,2016-11-29,2,2,8,4
air_6c91a28278a16f64,hpg_945c2807cef88022,2016-12-03,6,2,15,8
air_6c91a28278a16f64,hpg_945c2807cef88022,2016-12-10,4,5,29,9
air_6c91a28278a16f64,hpg_945c2807cef88022,2016-12-14,2,2,4,4
air_6c91a28278a16f64,hpg_945c2807cef88022,2016-12-17,11,3,22,14
air_6c91a28278a16f64,hpg_945c2807cef88022,2016-12-18,6,6,19,12
air_6c91a28278a16f64,hpg_945c2807cef88022,2016-12-21,4,2,12,6
air_6c91a28278a16f64,hpg_945c2807cef88022,2016-12-22,4,2,7,6
air_6c91a28278a16f64,hpg_945c2807cef88022,2016-12-23,6,4,32,10
air_6c91a28278a16f64,hpg_945c2807cef88022,2016-12-24,12,11,19,23
air_6c91a28278a16f64,hpg_945c2807cef88022,2016-12-25,4,4,25,8
air_6c91a28278a16f64,hpg_945c2807cef88022,2016-12-30,16,6,22,22
air_6c91a28278a16f64,hpg_945c2807cef88022,2017-01-03,8,8,20,16
air_6c91a28278a16f64,hpg_945c2807cef88022,2017-01-04,10,6,21,16
air_6c91a28278a16f64,hpg_945c2807cef88022,2017-01-05,6,6,21,12
air_6c91a28278a16f64,hpg_945c2807cef88022,2017-01-07,7,7,16,14
air_6c91a28278a16f64,hpg_945c2807cef88022,2017-01-09,2,2,9,4
air_6c91a28278a16f64,hpg_945c2807cef88022,2017-01-12,5,2,9,7
air_6c91a28278a16f64,hpg_945c2807cef88022,2017-01-13,4,3,15,7
air_6c91a28278a16f64,hpg_945c2807cef88022,2017-01-18,5,2,5,7
air_6c91a28278a16f64,hpg_945c2807cef88022,2017-01-22,7,9,20,16
air_6c91a28278a16f64,hpg_945c2807cef88022,2017-01-26,6,6,10,12
air_6c91a28278a16f64,hpg_945c2807cef88022,2017-02-09,2,4,2,6
air_6c91a28278a16f64,hpg_945c2807cef88022,2017-02-11,7,4,20,11
air_6c91a28278a16f64,hpg_945c2807cef88022,2017-02-18,6,4,20,10
air_6c91a28278a16f64,hpg_945c2807cef88022,2017-02-25,2,2,19,4
air_6c91a28278a16f64,hpg_945c2807cef88022,2017-02-26,2,2,24,4
air_6c91a28278a16f64,hpg_945c2807cef88022,2017-03-04,6,6,15,12
air_6c91a28278a16f64,hpg_945c2807cef88022,2017-03-05,2,2,10,4
air_6c91a28278a16f64,hpg_945c2807cef88022,2017-03-07,4,4,21,8
air_6c91a28278a16f64,hpg_945c2807cef88022,2017-03-11,4,4,25,8
air_6c91a28278a16f64,hpg_945c2807cef88022,2017-03-12,2,4,30,6
air_6c91a28278a16f64,hpg_945c2807cef88022,2017-03-13,4,4,8,8
air_6c91a28278a16f64,hpg_945c2807cef88022,2017-03-14,5,4,26,9
air_6c91a28278a16f64,hpg_945c2807cef88022,2017-03-17,2,5,11,7
air_6c91a28278a16f64,hpg_945c2807cef88022,2017-03-18,5,7,8,12
air_6c91a28278a16f64,hpg_945c2807cef88022,2017-03-19,2,2,30,4
air_6c91a28278a16f64,hpg_945c2807cef88022,2017-03-25,4,4,13,8
air_6c91a28278a16f64,hpg_945c2807cef88022,2017-03-30,2,2,23,4
air_6c91a28278a16f64,hpg_945c2807cef88022,2017-04-15,2,2,21,4
air_6c91a28278a16f64,hpg_945c2807cef88022,2017-04-16,2,2,14,4
air_8093d0b565e9dbdf,hpg_874415e6e7ccfe13,2016-01-12,20,2,35,22
air_8093d0b565e9dbdf,hpg_874415e6e7ccfe13,2016-01-15,33,2,53,35
air_8093d0b565e9dbdf,hpg_874415e6e7ccfe13,2016-02-25,19,3,25,22
air_8093d0b565e9dbdf,hpg_874415e6e7ccfe13,2016-02-26,55,11,59,66
air_8093d0b565e9dbdf,hpg_874415e6e7ccfe13,2016-02-29,29,55,43,84
air_8093d0b565e9dbdf,hpg_874415e6e7ccfe13,2016-03-04,46,16,69,62
air_8093d0b565e9dbdf,hpg_874415e6e7ccfe13,2016-03-17,35,18,35,53
air_8093d0b565e9dbdf,hpg_874415e6e7ccfe13,2016-03-18,55,6,53,61
air_8093d0b565e9dbdf,hpg_874415e6e7ccfe13,2016-03-19,20,2,38,22
air_8093d0b565e9dbdf,hpg_874415e6e7ccfe13,2016-03-25,57,8,78,65
air_8093d0b565e9dbdf,hpg_874415e6e7ccfe13,2016-03-31,28,2,38,30
air_8093d0b565e9dbdf,hpg_874415e6e7ccfe13,2016-04-08,38,8,55,46
air_8093d0b565e9dbdf,hpg_874415e6e7ccfe13,2016-04-12,39,2,39,41
air_8093d0b565e9dbdf,hpg_874415e6e7ccfe13,2016-04-14,10,2,17,12
air_8093d0b565e9dbdf,hpg_874415e6e7ccfe13,2016-04-22,50,5,61,55
air_8093d0b565e9dbdf,hpg_874415e6e7ccfe13,2016-04-29,20,2,24,22
air_8093d0b565e9dbdf,hpg_874415e6e7ccfe13,2016-10-28,37,5,45,42
air_8093d0b565e9dbdf,hpg_874415e6e7ccfe13,2016-11-11,34,2,46,36
air_8093d0b565e9dbdf,hpg_874415e6e7ccfe13,2016-11-18,28,3,45,31
air_8093d0b565e9dbdf,hpg_874415e6e7ccfe13,2016-11-19,15,3,20,18
air_8093d0b565e9dbdf,hpg_874415e6e7ccfe13,2016-11-22,40,10,54,50
air_8093d0b565e9dbdf,hpg_874415e6e7ccfe13,2016-11-23,19,4,28,23
air_8093d0b565e9dbdf,hpg_874415e6e7ccfe13,2016-11-24,10,6,23,16
air_8093d0b565e9dbdf,hpg_874415e6e7ccfe13,2016-11-25,40,4,56,44
air_8093d0b565e9dbdf,hpg_874415e6e7ccfe13,2016-11-30,27,2,38,29
air_8093d0b565e9dbdf,hpg_874415e6e7ccfe13,2016-12-07,26,2,32,28
air_8093d0b565e9dbdf,hpg_874415e6e7ccfe13,2016-12-08,40,5,43,45
air_8093d0b565e9dbdf,hpg_874415e6e7ccfe13,2016-12-09,47,3,63,50
air_8093d0b565e9dbdf,hpg_874415e6e7ccfe13,2016-12-10,22,5,42,27
air_8093d0b565e9dbdf,hpg_874415e6e7ccfe13,2016-12-11,27,12,27,39
air_8093d0b565e9dbdf,hpg_874415e6e7ccfe13,2016-12-12,26,8,33,34
air_8093d0b565e9dbdf,hpg_874415e6e7ccfe13,2016-12-14,49,2,56,51
air_8093d0b565e9dbdf,hpg_874415e6e7ccfe13,2016-12-15,44,4,49,48
air_8093d0b565e9dbdf,hpg_874415e6e7ccfe13,2016-12-16,65,5,79,70
air_8093d0b565e9dbdf,hpg_874415e6e7ccfe13,2016-12-17,25,4,30,29
air_8093d0b565e9dbdf,hpg_874415e6e7ccfe13,2016-12-20,21,2,47,23
air_8093d0b565e9dbdf,hpg_874415e6e7ccfe13,2016-12-21,45,2,60,47
air_8093d0b565e9dbdf,hpg_874415e6e7ccfe13,2016-12-22,55,32,74,87
air_8093d0b565e9dbdf,hpg_874415e6e7ccfe13,2016-12-23,32,2,45,34
air_8093d0b565e9dbdf,hpg_874415e6e7ccfe13,2016-12-24,26,2,49,28
air_8093d0b565e9dbdf,hpg_874415e6e7ccfe13,2016-12-25,28,2,46,30
air_8093d0b565e9dbdf,hpg_874415e6e7ccfe13,2016-12-26,54,11,62,65
air_8093d0b565e9dbdf,hpg_874415e6e7ccfe13,2016-12-27,40,8,59,48
air_8093d0b565e9dbdf,hpg_874415e6e7ccfe13,2016-12-28,32,34,55,66
air_8093d0b565e9dbdf,hpg_874415e6e7ccfe13,2016-12-29,40,8,62,48
air_8093d0b565e9dbdf,hpg_874415e6e7ccfe13,2017-01-05,20,2,31,22
air_8093d0b565e9dbdf,hpg_874415e6e7ccfe13,2017-01-06,23,3,42,26
air_8093d0b565e9dbdf,hpg_874415e6e7ccfe13,2017-01-11,34,10,44,44
air_8093d0b565e9dbdf,hpg_874415e6e7ccfe13,2017-01-13,36,3,53,39
air_8093d0b565e9dbdf,hpg_874415e6e7ccfe13,2017-01-14,34,10,46,44
air_8093d0b565e9dbdf,hpg_874415e6e7ccfe13,2017-01-18,39,5,49,44
air_8093d0b565e9dbdf,hpg_874415e6e7ccfe13,2017-01-19,32,2,49,34
air_8093d0b565e9dbdf,hpg_874415e6e7ccfe13,2017-01-20,36,9,52,45
air_8093d0b565e9dbdf,hpg_874415e6e7ccfe13,2017-01-22,33,2,42,35
air_8093d0b565e9dbdf,hpg_874415e6e7ccfe13,2017-01-31,30,4,35,34
air_8093d0b565e9dbdf,hpg_874415e6e7ccfe13,2017-02-01,22,4,33,26
air_8093d0b565e9dbdf,hpg_874415e6e7ccfe13,2017-02-08,26,2,42,28
air_8093d0b565e9dbdf,hpg_874415e6e7ccfe13,2017-02-10,34,16,54,50
air_8093d0b565e9dbdf,hpg_874415e6e7ccfe13,2017-02-11,22,5,44,27
air_8093d0b565e9dbdf,hpg_874415e6e7ccfe13,2017-02-17,54,8,62,62
air_8093d0b565e9dbdf,hpg_874415e6e7ccfe13,2017-02-24,46,12,65,58
air_8093d0b565e9dbdf,hpg_874415e6e7ccfe13,2017-03-01,27,2,42,29
air_8093d0b565e9dbdf,hpg_874415e6e7ccfe13,2017-03-03,28,2,46,30
air_8093d0b565e9dbdf,hpg_874415e6e7ccfe13,2017-03-04,19,4,33,23
air_8093d0b565e9dbdf,hpg_874415e6e7ccfe13,2017-03-09,45,2,49,47
air_8093d0b565e9dbdf,hpg_874415e6e7ccfe13,2017-03-12,13,3,26,16
air_8093d0b565e9dbdf,hpg_874415e6e7ccfe13,2017-03-15,34,11,46,45
air_8093d0b565e9dbdf,hpg_874415e6e7ccfe13,2017-03-17,35,3,65,38
air_8093d0b565e9dbdf,hpg_874415e6e7ccfe13,2017-03-21,17,2,33,19
air_8093d0b565e9dbdf,hpg_874415e6e7ccfe13,2017-03-24,51,2,66,53
air_8093d0b565e9dbdf,hpg_874415e6e7ccfe13,2017-03-29,32,2,47,34
air_8093d0b565e9dbdf,hpg_874415e6e7ccfe13,2017-03-30,43,8,58,51
air_8093d0b565e9dbdf,hpg_874415e6e7ccfe13,2017-03-31,53,8,64,61
air_8093d0b565e9dbdf,hpg_874415e6e7ccfe13,2017-04-07,33,12,51,45
air_8093d0b565e9dbdf,hpg_874415e6e7ccfe13,2017-04-10,25,8,39,33
air_8093d0b565e9dbdf,hpg_874415e6e7ccfe13,2017-04-19,24,2,39,26
air_8093d0b565e9dbdf,hpg_874415e6e7ccfe13,2017-04-20,39,15,42,54
air_8093d0b565e9dbdf,hpg_874415e6e7ccfe13,2017-04-21,29,4,45,33
air_b45b8e456f53942a,hpg_a85b37424291216b,2016-07-01,6,2,24,8
air_b45b8e456f53942a,hpg_a85b37424291216b,2016-07-05,6,2,11,8
air_b45b8e456f53942a,hpg_a85b37424291216b,2016-07-09,8,2,11,10
air_b45b8e456f53942a,hpg_a85b37424291216b,2016-07-15,10,2,18,12
air_b45b8e456f53942a,hpg_a85b37424291216b,2016-07-16,4,2,7,6
air_b45b8e456f53942a,hpg_a85b37424291216b,2016-07-17,12,4,13,16
air_b45b8e456f53942a,hpg_a85b37424291216b,2016-07-21,15,2,19,17
air_b45b8e456f53942a,hpg_a85b37424291216b,2016-07-23,12,8,10,20
air_b45b8e456f53942a,hpg_a85b37424291216b,2016-11-04,14,2,15,16
air_b45b8e456f53942a,hpg_a85b37424291216b,2016-11-09,2,2,2,4
air_b45b8e456f53942a,hpg_a85b37424291216b,2016-11-14,3,3,3,6
air_b45b8e456f53942a,hpg_a85b37424291216b,2016-11-18,8,2,10,10
air_b45b8e456f53942a,hpg_a85b37424291216b,2016-11-19,7,3,11,10
air_b45b8e456f53942a,hpg_a85b37424291216b,2016-11-22,8,6,11,14
air_b45b8e456f53942a,hpg_a85b37424291216b,2016-11-25,6,6,12,12
air_b45b8e456f53942a,hpg_a85b37424291216b,2016-11-26,6,2,15,8
air_b45b8e456f53942a,hpg_a85b37424291216b,2016-12-01,6,6,8,12
air_b45b8e456f53942a,hpg_a85b37424291216b,2016-12-03,15,9,17,24
air_b45b8e456f53942a,hpg_a85b37424291216b,2016-12-07,4,2,8,6
air_b45b8e456f53942a,hpg_a85b37424291216b,2016-12-10,7,5,7,12
air_b45b8e456f53942a,hpg_a85b37424291216b,2016-12-11,2,2,9,4
air_b45b8e456f53942a,hpg_a85b37424291216b,2016-12-13,2,2,4,4
air_b45b8e456f53942a,hpg_a85b37424291216b,2016-12-14,6,6,8,12
air_b45b8e456f53942a,hpg_a85b37424291216b,2016-12-15,13,4,13,17
air_b45b8e456f53942a,hpg_a85b37424291216b,2016-12-16,12,3,10,15
air_b45b8e456f53942a,hpg_a85b37424291216b,2016-12-17,12,2,20,14
air_b45b8e456f53942a,hpg_a85b37424291216b,2016-12-21,9,2,14,11
air_b45b8e456f53942a,hpg_a85b37424291216b,2016-12-22,21,21,25,42
air_b45b8e456f53942a,hpg_a85b37424291216b,2016-12-23,12,4,13,16
air_b45b8e456f53942a,hpg_a85b37424291216b,2016-12-24,12,6,15,18
air_b45b8e456f53942a,hpg_a85b37424291216b,2016-12-27,2,2,18,4
air_b45b8e456f53942a,hpg_a85b37424291216b,2016-12-28,16,13,24,29
air_b45b8e456f53942a,hpg_a85b37424291216b,2016-12-30,14,2,26,16
air_b45b8e456f53942a,hpg_a85b37424291216b,2017-01-02,11,3,19,14
air_b45b8e456f53942a,hpg_a85b37424291216b,2017-01-04,12,4,15,16
air_b45b8e456f53942a,hpg_a85b37424291216b,2017-01-05,4,4,4,8
air_b45b8e456f53942a,hpg_a85b37424291216b,2017-01-07,11,2,10,13
air_b45b8e456f53942a,hpg_a85b37424291216b,2017-01-08,3,3,7,6
air_b45b8e456f53942a,hpg_a85b37424291216b,2017-01-11,2,2,8,4
air_b45b8e456f53942a,hpg_a85b37424291216b,2017-01-12,14,9,14,23
air_b45b8e456f53942a,hpg_a85b37424291216b,2017-01-13,9,5,10,14
air_b45b8e456f53942a,hpg_a85b37424291216b,2017-01-14,14,5,18,19
air_b45b8e456f53942a,hpg_a85b37424291216b,2017-01-17,4,2,8,6
air_b45b8e456f53942a,hpg_a85b37424291216b,2017-01-20,9,4,18,13
air_b45b8e456f53942a,hpg_a85b37424291216b,2017-01-21,15,2,15,17
air_b45b8e456f53942a,hpg_a85b37424291216b,2017-01-25,6,2,6,8
air_b45b8e456f53942a,hpg_a85b37424291216b,2017-01-27,15,6,18,21
air_b45b8e456f53942a,hpg_a85b37424291216b,2017-01-28,14,4,12,18
air_b45b8e456f53942a,hpg_a85b37424291216b,2017-01-31,3,3,9,6
air_b45b8e456f53942a,hpg_a85b37424291216b,2017-02-01,2,2,5,4
air_b45b8e456f53942a,hpg_a85b37424291216b,2017-02-02,2,2,6,4
air_b45b8e456f53942a,hpg_a85b37424291216b,2017-02-03,9,2,14,11
air_b45b8e456f53942a,hpg_a85b37424291216b,2017-02-04,10,6,19,16
air_b45b8e456f53942a,hpg_a85b37424291216b,2017-02-08,6,2,16,8
air_b45b8e456f53942a,hpg_a85b37424291216b,2017-02-09,6,4,9,10
air_b45b8e456f53942a,hpg_a85b37424291216b,2017-02-11,20,4,29,24
air_b45b8e456f53942a,hpg_a85b37424291216b,2017-02-13,6,4,10,10
air_b45b8e456f53942a,hpg_a85b37424291216b,2017-02-16,2,4,2,6
air_b45b8e456f53942a,hpg_a85b37424291216b,2017-02-17,16,6,16,22
air_b45b8e456f53942a,hpg_a85b37424291216b,2017-02-18,16,2,22,18
air_b45b8e456f53942a,hpg_a85b37424291216b,2017-02-21,2,2,5,4
air_b45b8e456f53942a,hpg_a85b37424291216b,2017-02-24,17,4,20,21
air_b45b8e456f53942a,hpg_a85b37424291216b,2017-02-27,2,2,5,4
air_b45b8e456f53942a,hpg_a85b37424291216b,2017-03-06,8,9,11,17
air_b45b8e456f53942a,hpg_a85b37424291216b,2017-03-07,2,2,5,4
air_b45b8e456f53942a,hpg_a85b37424291216b,2017-03-09,5,4,19,9
air_b45b8e456f53942a,hpg_a85b37424291216b,2017-03-11,8,6,30,14
air_b45b8e456f53942a,hpg_a85b37424291216b,2017-03-14,4,6,6,10
air_b45b8e456f53942a,hpg_a85b37424291216b,2017-03-16,6,2,13,8
air_b45b8e456f53942a,hpg_a85b37424291216b,2017-03-17,7,7,16,14
air_b45b8e456f53942a,hpg_a85b37424291216b,2017-03-19,10,9,28,19
air_b45b8e456f53942a,hpg_a85b37424291216b,2017-03-21,13,4,23,17
air_b45b8e456f53942a,hpg_a85b37424291216b,2017-03-22,2,2,10,4
air_b45b8e456f53942a,hpg_a85b37424291216b,2017-03-24,15,10,25,25
air_b45b8e456f53942a,hpg_a85b37424291216b,2017-03-27,4,5,11,9
air_b45b8e456f53942a,hpg_a85b37424291216b,2017-03-31,9,6,19,15
air_b45b8e456f53942a,hpg_a85b37424291216b,2017-04-01,10,6,20,16
air_b45b8e456f53942a,hpg_a85b37424291216b,2017-04-04,7,5,9,12
air_b45b8e456f53942a,hpg_a85b37424291216b,2017-04-06,2,2,6,4
air_b45b8e456f53942a,hpg_a85b37424291216b,2017-04-14,18,6,25,24
air_b45b8e456f53942a,hpg_a85b37424291216b,2017-04-15,17,2,18,19
air_b45b8e456f53942a,hpg_a85b37424291216b,2017-04-21,10,9,17,19
air_b45b8e456f53942a,hpg_a85b37424291216b,2017-04-22,10,6,13,16
air_08cb3c4ee6cd6a22,hpg_dc639640420bde5f,2016-10-28,9,11,22,20
air_08cb3c4ee6cd6a22,hpg_dc639640420bde5f,2016-10-30,7,3,13,10
air_08cb3c4ee6cd6a22,hpg_dc639640420bde5f,2016-11-02,22,4,12,26
air_08cb3c4ee6cd6a22,hpg_dc639640420bde5f,2016-11-03,5,3,29,8
air_08cb3c4ee6cd6a22,hpg_dc639640420bde5f,2016-11-05,12,3,15,15
air_08cb3c4ee6cd6a22,hpg_dc639640420bde5f,2016-11-07,4,6,9,10
air_08cb3c4ee6cd6a22,hpg_dc639640420bde5f,2016-11-10,9,6,18,15
air_08cb3c4ee6cd6a22,hpg_dc639640420bde5f,2016-11-12,14,4,17,18
air_08cb3c4ee6cd6a22,hpg_dc639640420bde5f,2016-11-15,2,2,7,4
air_08cb3c4ee6cd6a22,hpg_dc639640420bde5f,2016-11-16,8,4,24,12
air_08cb3c4ee6cd6a22,hpg_dc639640420bde5f,2016-11-18,4,2,20,6
air_08cb3c4ee6cd6a22,hpg_dc639640420bde5f,2016-11-19,5,2,22,7
air_08cb3c4ee6cd6a22,hpg_dc639640420bde5f,2016-11-22,11,9,23,20
air_08cb3c4ee6cd6a22,hpg_dc639640420bde5f,2016-11-23,11,7,17,18
air_08cb3c4ee6cd6a22,hpg_dc639640420bde5f,2016-11-24,2,2,4,4
air_08cb3c4ee6cd6a22,hpg_dc639640420bde5f,2016-11-25,12,8,18,20
air_08cb3c4ee6cd6a22,hpg_dc639640420bde5f,2016-11-26,22,18,25,40
air_08cb3c4ee6cd6a22,hpg_dc639640420bde5f,2016-11-30,2,2,8,4
air_08cb3c4ee6cd6a22,hpg_dc639640420bde5f,2016-12-02,15,4,23,19
air_08cb3c4ee6cd6a22,hpg_dc639640420bde5f,2016-12-03,13,18,17,31
air_08cb3c4ee6cd6a22,hpg_dc639640420bde5f,2016-12-04,19,4,24,23
air_08cb3c4ee6cd6a22,hpg_dc639640420bde5f,2016-12-05,2,2,4,4
air_08cb3c4ee6cd6a22,hpg_dc639640420bde5f,2016-12-07,2,7,6,9
air_08cb3c4ee6cd6a22,hpg_dc639640420bde5f,2016-12-09,17,4,28,21
air_08cb3c4ee6cd6a22,hpg_dc639640420bde5f,2016-12-10,20,5,24,25
air_08cb3c4ee6cd6a22,hpg_dc639640420bde5f,2016-12-11,3,3,7,6
air_08cb3c4ee6cd6a22,hpg_dc639640420bde5f,2016-12-12,13,7,17,20
air_08cb3c4ee6cd6a22,hpg_dc639640420bde5f,2016-12-13,8,3,6,11
air_08cb3c4ee6cd6a22,hpg_dc639640420bde5f,2016-12-14,7,7,15,14
air_08cb3c4ee6cd6a22,hpg_dc639640420bde5f,2016-12-16,22,17,29,39
air_08cb3c4ee6cd6a22,hpg_dc639640420bde5f,2016-12-17,22,14,34,36
air_08cb3c4ee6cd6a22,hpg_dc639640420bde5f,2016-12-21,22,17,27,39
air_08cb3c4ee6cd6a22,hpg_dc639640420bde5f,2016-12-22,26,22,27,48
air_08cb3c4ee6cd6a22,hpg_dc639640420bde5f,2016-12-23,16,8,18,24
air_08cb3c4ee6cd6a22,hpg_dc639640420bde5f,2016-12-25,10,10,18,20
air_08cb3c4ee6cd6a22,hpg_dc639640420bde5f,2016-12-26,14,14,23,28
air_08cb3c4ee6cd6a22,hpg_dc639640420bde5f,2016-12-27,21,8,22,29
air_08cb3c4ee6cd6a22,hpg_dc639640420bde5f,2016-12-28,22,24,30,46
air_08cb3c4ee6cd6a22,hpg_dc639640420bde5f,2016-12-29,18,5,18,23
air_08cb3c4ee6cd6a22,hpg_dc639640420bde5f,2016-12-30,20,9,19,29
air_08cb3c4ee6cd6a22,hpg_dc639640420bde5f,2016-12-31,20,7,33,27
air_08cb3c4ee6cd6a22,hpg_dc639640420bde5f,2017-01-01,28,11,40,39
air_08cb3c4ee6cd6a22,hpg_dc639640420bde5f,2017-01-02,39,12,38,51
air_08cb3c4ee6cd6a22,hpg_dc639640420bde5f,2017-01-03,13,4,30,17
air_08cb3c4ee6cd6a22,hpg_dc639640420bde5f,2017-01-05,6,6,8,12
air_08cb3c4ee6cd6a22,hpg_dc639640420bde5f,2017-01-09,14,14,15,28
air_08cb3c4ee6cd6a22,hpg_dc639640420bde5f,2017-01-11,2,2,13,4
air_08cb3c4ee6cd6a22,hpg_dc639640420bde5f,2017-01-12,22,4,24,26
air_08cb3c4ee6cd6a22,hpg_dc639640420bde5f,2017-01-14,21,8,23,29
air_08cb3c4ee6cd6a22,hpg_dc639640420bde5f,2017-01-16,2,2,10,4
air_08cb3c4ee6cd6a22,hpg_dc639640420bde5f,2017-01-17,9,6,15,15
air_08cb3c4ee6cd6a22,hpg_dc639640420bde5f,2017-01-19,3,5,11,8
air_08cb3c4ee6cd6a22,hpg_dc639640420bde5f,2017-01-20,8,4,13,12
air_08cb3c4ee6cd6a22,hpg_dc639640420bde5f,2017-01-21,18,5,14,23
air_08cb3c4ee6cd6a22,hpg_dc639640420bde5f,2017-01-22,5,3,11,8
air_08cb3c4ee6cd6a22,hpg_dc639640420bde5f,2017-01-23,3,3,13,6
air_08cb3c4ee6cd6a22,hpg_dc639640420bde5f,2017-01-25,4,4,13,8
air_08cb3c4ee6cd6a22,hpg_dc639640420bde5f,2017-01-27,2,2,24,4
air_08cb3c4ee6cd6a22,hpg_dc639640420bde5f,2017-01-28,19,19,25,38
air_08cb3c4ee6cd6a22,hpg_dc639640420bde5f,2017-01-29,2,7,8,9
air_08cb3c4ee6cd6a22,hpg_dc639640420bde5f,2017-01-30,5,5,13,10
air_08cb3c4ee6cd6a22,hpg_dc639640420bde5f,2017-01-31,17,7,21,24
air_08cb3c4ee6cd6a22,hpg_dc639640420bde5f,2017-02-04,22,5,20,27
air_08cb3c4ee6cd6a22,hpg_dc639640420bde5f,2017-02-05,2,2,8,4
air_08cb3c4ee6cd6a22,hpg_dc639640420bde5f,2017-02-06,13,13,19,26
air_08cb3c4ee6cd6a22,hpg_dc639640420bde5f,2017-02-08,5,2,16,7
air_08cb3c4ee6cd6a22,hpg_dc639640420bde5f,2017-02-09,12,9,15,21
air_08cb3c4ee6cd6a22,hpg_dc639640420bde5f,2017-02-10,22,12,29,34
air_08cb3c4ee6cd6a22,hpg_dc639640420bde5f,2017-02-11,21,17,38,38
air_08cb3c4ee6cd6a22,hpg_dc639640420bde5f,2017-02-12,7,7,12,14
air_08cb3c4ee6cd6a22,hpg_dc639640420bde5f,2017-02-13,4,4,12,8
air_08cb3c4ee6cd6a22,hpg_dc639640420bde5f,2017-02-16,8,10,8,18
air_08cb3c4ee6cd6a22,hpg_dc639640420bde5f,2017-02-17,11,3,21,14
air_08cb3c4ee6cd6a22,hpg_dc639640420bde5f,2017-02-18,9,2,20,11
air_08cb3c4ee6cd6a22,hpg_dc639640420bde5f,2017-02-19,3,3,23,6
air_08cb3c4ee6cd6a22,hpg_dc639640420bde5f,2017-02-22,9,6,12,15
air_08cb3c4ee6cd6a22,hpg_dc639640420bde5f,2017-02-23,3,3,12,6
air_08cb3c4ee6cd6a22,hpg_dc639640420bde5f,2017-02-24,4,6,10,10
air_08cb3c4ee6cd6a22,hpg_dc639640420bde5f,2017-02-25,23,12,29,35
air_08cb3c4ee6cd6a22,hpg_dc639640420bde5f,2017-02-28,3,3,7,6
air_08cb3c4ee6cd6a22,hpg_dc639640420bde5f,2017-03-03,5,2,7,7
air_08cb3c4ee6cd6a22,hpg_dc639640420bde5f,2017-03-05,4,6,19,10
air_08cb3c4ee6cd6a22,hpg_dc639640420bde5f,2017-03-06,2,2,8,4
air_08cb3c4ee6cd6a22,hpg_dc639640420bde5f,2017-03-09,16,7,20,23
air_08cb3c4ee6cd6a22,hpg_dc639640420bde5f,2017-03-10,7,7,6,14
air_08cb3c4ee6cd6a22,hpg_dc639640420bde5f,2017-03-11,20,10,32,30
air_08cb3c4ee6cd6a22,hpg_dc639640420bde5f,2017-03-12,8,5,17,13
air_08cb3c4ee6cd6a22,hpg_dc639640420bde5f,2017-03-13,2,2,13,4
air_08cb3c4ee6cd6a22,hpg_dc639640420bde5f,2017-03-15,7,3,11,10
air_08cb3c4ee6cd6a22,hpg_dc639640420bde5f,2017-03-17,4,4,5,8
air_08cb3c4ee6cd6a22,hpg_dc639640420bde5f,2017-03-18,30,19,38,49
air_08cb3c4ee6cd6a22,hpg_dc639640420bde5f,2017-03-19,18,16,26,34
air_08cb3c4ee6cd6a22,hpg_dc639640420bde5f,2017-03-21,4,4,8,8
air_08cb3c4ee6cd6a22,hpg_dc639640420bde5f,2017-03-22,9,9,14,18
air_08cb3c4ee6cd6a22,hpg_dc639640420bde5f,2017-03-24,21,15,23,36
air_08cb3c4ee6cd6a22,hpg_dc639640420bde5f,2017-03-25,10,8,18,18
air_08cb3c4ee6cd6a22,hpg_dc639640420bde5f,2017-03-26,16,16,22,32
air_08cb3c4ee6cd6a22,hpg_dc639640420bde5f,2017-03-27,17,2,4,19
air_08cb3c4ee6cd6a22,hpg_dc639640420bde5f,2017-03-28,11,4,32,15
air_08cb3c4ee6cd6a22,hpg_dc639640420bde5f,2017-03-30,5,5,10,10
air_08cb3c4ee6cd6a22,hpg_dc639640420bde5f,2017-03-31,10,8,12,18
air_08cb3c4ee6cd6a22,hpg_dc639640420bde5f,2017-04-01,11,2,17,13
air_08cb3c4ee6cd6a22,hpg_dc639640420bde5f,2017-04-02,2,2,9,4
air_08cb3c4ee6cd6a22,hpg_dc639640420bde5f,2017-04-06,8,2,14,10
air_08cb3c4ee6cd6a22,hpg_dc639640420bde5f,2017-04-09,7,9,17,16
air_08cb3c4ee6cd6a22,hpg_dc639640420bde5f,2017-04-16,4,4,10,8
air_08cb3c4ee6cd6a22,hpg_dc639640420bde5f,2017-04-17,6,6,12,12
air_08cb3c4ee6cd6a22,hpg_dc639640420bde5f,2017-04-22,21,19,18,40
air_db4b38ebe7a7ceff,hpg_bcecaa70222d94e5,2016-01-23,13,3,23,16
air_db4b38ebe7a7ceff,hpg_bcecaa70222d94e5,2016-01-29,8,2,20,10
air_db4b38ebe7a7ceff,hpg_bcecaa70222d94e5,2016-01-31,13,2,25,15
air_db4b38ebe7a7ceff,hpg_bcecaa70222d94e5,2016-02-08,8,2,10,10
air_db4b38ebe7a7ceff,hpg_bcecaa70222d94e5,2016-02-29,11,3,13,14
air_db4b38ebe7a7ceff,hpg_bcecaa70222d94e5,2016-03-05,16,4,22,20
air_db4b38ebe7a7ceff,hpg_bcecaa70222d94e5,2016-03-30,8,8,17,16
air_db4b38ebe7a7ceff,hpg_bcecaa70222d94e5,2016-04-10,1,4,9,5
air_db4b38ebe7a7ceff,hpg_bcecaa70222d94e5,2016-04-16,11,6,26,17
air_db4b38ebe7a7ceff,hpg_bcecaa70222d94e5,2016-04-17,4,2,19,6
air_db4b38ebe7a7ceff,hpg_bcecaa70222d94e5,2016-04-28,7,7,17,14
air_db4b38ebe7a7ceff,hpg_bcecaa70222d94e5,2016-04-30,13,2,20,15
air_db4b38ebe7a7ceff,hpg_bcecaa70222d94e5,2016-05-04,3,5,20,8
air_db4b38ebe7a7ceff,hpg_bcecaa70222d94e5,2016-05-06,9,7,22,16
air_db4b38ebe7a7ceff,hpg_bcecaa70222d94e5,2016-05-12,5,4,13,9
air_db4b38ebe7a7ceff,hpg_bcecaa70222d94e5,2016-05-20,2,2,17,4
air_db4b38ebe7a7ceff,hpg_bcecaa70222d94e5,2016-10-30,5,5,28,10
air_db4b38ebe7a7ceff,hpg_bcecaa70222d94e5,2016-10-31,2,2,17,4
air_db4b38ebe7a7ceff,hpg_bcecaa70222d94e5,2016-11-04,5,2,8,7
air_db4b38ebe7a7ceff,hpg_bcecaa70222d94e5,2016-11-05,15,18,27,33
air_db4b38ebe7a7ceff,hpg_bcecaa70222d94e5,2016-11-14,3,3,18,6
air_db4b38ebe7a7ceff,hpg_bcecaa70222d94e5,2016-11-17,7,7,12,14
air_db4b38ebe7a7ceff,hpg_bcecaa70222d94e5,2016-11-18,14,8,28,22
air_db4b38ebe7a7ceff,hpg_bcecaa70222d94e5,2016-11-21,20,2,25,22
air_db4b38ebe7a7ceff,hpg_bcecaa70222d94e5,2016-11-24,4,2,11,6
air_db4b38ebe7a7ceff,hpg_bcecaa70222d94e5,2016-11-25,11,4,27,15
air_db4b38ebe7a7ceff,hpg_bcecaa70222d94e5,2016-11-26,9,7,24,16
air_db4b38ebe7a7ceff,hpg_bcecaa70222d94e5,2016-12-05,3,3,13,6
air_db4b38ebe7a7ceff,hpg_bcecaa70222d94e5,2016-12-09,12,5,16,17
air_db4b38ebe7a7ceff,hpg_bcecaa70222d94e5,2016-12-11,6,6,13,12
air_db4b38ebe7a7ceff,hpg_bcecaa70222d94e5,2016-12-13,7,4,15,11
air_db4b38ebe7a7ceff,hpg_bcecaa70222d94e5,2016-12-19,6,3,41,9
air_db4b38ebe7a7ceff,hpg_bcecaa70222d94e5,2016-12-20,8,6,16,14
air_db4b38ebe7a7ceff,hpg_bcecaa70222d94e5,2016-12-22,15,14,20,29
air_db4b38ebe7a7ceff,hpg_bcecaa70222d94e5,2016-12-23,14,2,27,16
air_db4b38ebe7a7ceff,hpg_bcecaa70222d94e5,2016-12-29,12,2,37,14
air_db4b38ebe7a7ceff,hpg_bcecaa70222d94e5,2016-12-30,17,2,30,19
air_db4b38ebe7a7ceff,hpg_bcecaa70222d94e5,2017-01-07,21,10,22,31
air_db4b38ebe7a7ceff,hpg_bcecaa70222d94e5,2017-01-14,17,4,22,21
air_db4b38ebe7a7ceff,hpg_bcecaa70222d94e5,2017-01-20,11,3,19,14
air_db4b38ebe7a7ceff,hpg_bcecaa70222d94e5,2017-02-03,3,3,14,6
air_db4b38ebe7a7ceff,hpg_bcecaa70222d94e5,2017-02-05,11,2,23,13
air_db4b38ebe7a7ceff,hpg_bcecaa70222d94e5,2017-02-09,11,8,18,19
air_db4b38ebe7a7ceff,hpg_bcecaa70222d94e5,2017-02-10,4,2,16,6
air_db4b38ebe7a7ceff,hpg_bcecaa70222d94e5,2017-02-14,6,4,20,10
air_db4b38ebe7a7ceff,hpg_bcecaa70222d94e5,2017-02-16,8,2,13,10
air_db4b38ebe7a7ceff,hpg_bcecaa70222d94e5,2017-02-21,3,3,20,6
air_db4b38ebe7a7ceff,hpg_bcecaa70222d94e5,2017-02-25,19,7,20,26
air_db4b38ebe7a7ceff,hpg_bcecaa70222d94e5,2017-03-04,15,6,27,21
air_db4b38ebe7a7ceff,hpg_bcecaa70222d94e5,2017-03-05,12,4,24,16
air_db4b38ebe7a7ceff,hpg_bcecaa70222d94e5,2017-03-16,14,4,14,18
air_db4b38ebe7a7ceff,hpg_bcecaa70222d94e5,2017-03-17,9,3,26,12
air_db4b38ebe7a7ceff,hpg_bcecaa70222d94e5,2017-03-25,13,5,25,18
air_db4b38ebe7a7ceff,hpg_bcecaa70222d94e5,2017-03-26,15,6,22,21
air_db4b38ebe7a7ceff,hpg_bcecaa70222d94e5,2017-03-27,7,3,10,10
air_db4b38ebe7a7ceff,hpg_bcecaa70222d94e5,2017-04-01,16,2,24,18
air_db4b38ebe7a7ceff,hpg_bcecaa70222d94e5,2017-04-04,6,4,21,10
air_db4b38ebe7a7ceff,hpg_bcecaa70222d94e5,2017-04-08,16,8,27,24
air_db4b38ebe7a7ceff,hpg_bcecaa70222d94e5,2017-04-10,12,2,36,14
air_db4b38ebe7a7ceff,hpg_bcecaa70222d94e5,2017-04-13,22,7,31,29
air_db4b38ebe7a7ceff,hpg_bcecaa70222d94e5,2017-04-15,19,2,28,21
air_db4b38ebe7a7ceff,hpg_bcecaa70222d94e5,2017-04-20,2,2,10,4
air_db4b38ebe7a7ceff,hpg_bcecaa70222d94e5,2017-04-21,15,4,17,19
air_68301bcb11e2f389,hpg_2c09f3abb2220659,2017-01-25,2,2,35,4
air_3980af67be35afdb,hpg_7819244b4f2e0def,2016-11-15,2,2,21,4
air_3980af67be35afdb,hpg_7819244b4f2e0def,2016-12-01,5,11,28,16
air_3980af67be35afdb,hpg_7819244b4f2e0def,2016-12-16,13,14,24,27
air_3980af67be35afdb,hpg_7819244b4f2e0def,2016-12-17,8,8,20,16
air_3980af67be35afdb,hpg_7819244b4f2e0def,2016-12-21,9,8,23,17
air_3980af67be35afdb,hpg_7819244b4f2e0def,2016-12-22,7,13,20,20
air_3980af67be35afdb,hpg_7819244b4f2e0def,2016-12-27,4,4,14,8
air_3980af67be35afdb,hpg_7819244b4f2e0def,2017-01-20,11,11,24,22
air_ade6e836ffd1da64,hpg_cd98b0cad88f7123,2016-12-05,2,2,3,4
air_ade6e836ffd1da64,hpg_cd98b0cad88f7123,2017-01-20,2,11,14,13
air_ade6e836ffd1da64,hpg_cd98b0cad88f7123,2017-01-25,3,3,13,6
air_ade6e836ffd1da64,hpg_cd98b0cad88f7123,2017-02-18,7,7,11,14
air_ade6e836ffd1da64,hpg_cd98b0cad88f7123,2017-03-08,2,2,5,4
air_ade6e836ffd1da64,hpg_cd98b0cad88f7123,2017-04-05,4,14,12,18
air_5e70fe82f9e4fab6,hpg_0a8cb1f2f6e27889,2016-01-08,4,4,15,8
air_5e70fe82f9e4fab6,hpg_0a8cb1f2f6e27889,2016-03-19,2,2,13,4
air_5e70fe82f9e4fab6,hpg_0a8cb1f2f6e27889,2016-04-04,2,2,16,4
air_5e70fe82f9e4fab6,hpg_0a8cb1f2f6e27889,2016-10-30,2,2,12,4
air_5e70fe82f9e4fab6,hpg_0a8cb1f2f6e27889,2016-11-03,2,2,10,4
air_5e70fe82f9e4fab6,hpg_0a8cb1f2f6e27889,2016-11-20,2,2,12,4
air_5e70fe82f9e4fab6,hpg_0a8cb1f2f6e27889,2016-11-26,7,7,15,14
air_5e70fe82f9e4fab6,hpg_0a8cb1f2f6e27889,2016-11-30,2,2,12,4
air_5e70fe82f9e4fab6,hpg_0a8cb1f2f6e27889,2016-12-11,2,2,21,4
air_5e70fe82f9e4fab6,hpg_0a8cb1f2f6e27889,2016-12-16,2,2,24,4
air_5e70fe82f9e4fab6,hpg_0a8cb1f2f6e27889,2017-01-05,2,2,15,4
air_5e70fe82f9e4fab6,hpg_0a8cb1f2f6e27889,2017-01-08,3,2,13,5
air_5e70fe82f9e4fab6,hpg_0a8cb1f2f6e27889,2017-02-10,5,2,22,7
air_5e70fe82f9e4fab6,hpg_0a8cb1f2f6e27889,2017-02-22,2,2,11,4
air_5e70fe82f9e4fab6,hpg_0a8cb1f2f6e27889,2017-03-01,2,2,9,4
air_5e70fe82f9e4fab6,hpg_0a8cb1f2f6e27889,2017-03-16,2,4,20,6
air_5e70fe82f9e4fab6,hpg_0a8cb1f2f6e27889,2017-04-09,2,2,7,4
air_5e70fe82f9e4fab6,hpg_0a8cb1f2f6e27889,2017-04-22,2,2,13,4
air_32b02ba5dc2027f4,hpg_168a90866d6e606d,2016-11-11,5,5,31,10
air_32b02ba5dc2027f4,hpg_168a90866d6e606d,2016-11-28,5,5,7,10
air_32b02ba5dc2027f4,hpg_168a90866d6e606d,2016-12-05,20,20,32,40
air_32b02ba5dc2027f4,hpg_168a90866d6e606d,2016-12-09,44,8,67,52
air_32b02ba5dc2027f4,hpg_168a90866d6e606d,2016-12-14,20,17,50,37
air_32b02ba5dc2027f4,hpg_168a90866d6e606d,2016-12-15,37,15,54,52
air_32b02ba5dc2027f4,hpg_168a90866d6e606d,2016-12-16,35,56,86,91
air_32b02ba5dc2027f4,hpg_168a90866d6e606d,2016-12-22,76,45,97,121
air_32b02ba5dc2027f4,hpg_168a90866d6e606d,2016-12-23,33,32,62,65
air_32b02ba5dc2027f4,hpg_168a90866d6e606d,2016-12-28,108,78,162,186
air_32b02ba5dc2027f4,hpg_168a90866d6e606d,2017-01-12,12,12,24,24
air_32b02ba5dc2027f4,hpg_168a90866d6e606d,2017-02-10,11,11,39,22
air_32b02ba5dc2027f4,hpg_168a90866d6e606d,2017-02-18,30,29,55,59
air_32b02ba5dc2027f4,hpg_168a90866d6e606d,2017-02-22,2,2,20,4
air_32b02ba5dc2027f4,hpg_168a90866d6e606d,2017-03-07,3,3,10,6
air_32b02ba5dc2027f4,hpg_168a90866d6e606d,2017-03-25,3,3,30,6
air_32b02ba5dc2027f4,hpg_168a90866d6e606d,2017-04-03,12,12,42,24
air_32b02ba5dc2027f4,hpg_168a90866d6e606d,2017-04-05,17,17,93,34
air_32b02ba5dc2027f4,hpg_168a90866d6e606d,2017-04-13,6,6,35,12
air_cb7467aed805e7fe,hpg_aa7dfdc68a0a879c,2016-12-06,4,2,47,6
air_cb7467aed805e7fe,hpg_aa7dfdc68a0a879c,2016-12-17,16,18,80,34
air_2fc478dc9f0a6b31,hpg_2d0a73d3f1cb646d,2016-07-01,4,4,9,8
air_2fc478dc9f0a6b31,hpg_2d0a73d3f1cb646d,2016-07-08,9,4,19,13
air_2fc478dc9f0a6b31,hpg_2d0a73d3f1cb646d,2016-07-09,15,2,21,17
air_2fc478dc9f0a6b31,hpg_2d0a73d3f1cb646d,2016-10-28,18,8,18,26
air_2fc478dc9f0a6b31,hpg_2d0a73d3f1cb646d,2016-10-29,16,4,20,20
air_2fc478dc9f0a6b31,hpg_2d0a73d3f1cb646d,2016-11-02,10,4,12,14
air_2fc478dc9f0a6b31,hpg_2d0a73d3f1cb646d,2016-11-04,2,2,8,4
air_2fc478dc9f0a6b31,hpg_2d0a73d3f1cb646d,2016-11-05,6,2,6,8
air_2fc478dc9f0a6b31,hpg_2d0a73d3f1cb646d,2016-11-06,2,3,2,5
air_2fc478dc9f0a6b31,hpg_2d0a73d3f1cb646d,2016-11-08,2,2,4,4
air_2fc478dc9f0a6b31,hpg_2d0a73d3f1cb646d,2016-11-10,7,7,11,14
air_2fc478dc9f0a6b31,hpg_2d0a73d3f1cb646d,2016-11-11,10,5,11,15
air_2fc478dc9f0a6b31,hpg_2d0a73d3f1cb646d,2016-11-12,12,8,16,20
air_2fc478dc9f0a6b31,hpg_2d0a73d3f1cb646d,2016-11-13,6,2,4,8
air_2fc478dc9f0a6b31,hpg_2d0a73d3f1cb646d,2016-11-15,12,4,18,16
air_2fc478dc9f0a6b31,hpg_2d0a73d3f1cb646d,2016-11-17,2,2,2,4
air_2fc478dc9f0a6b31,hpg_2d0a73d3f1cb646d,2016-11-18,4,2,4,6
air_2fc478dc9f0a6b31,hpg_2d0a73d3f1cb646d,2016-11-19,6,2,8,8
air_2fc478dc9f0a6b31,hpg_2d0a73d3f1cb646d,2016-11-22,12,5,16,17
air_2fc478dc9f0a6b31,hpg_2d0a73d3f1cb646d,2016-11-23,7,7,7,14
air_2fc478dc9f0a6b31,hpg_2d0a73d3f1cb646d,2016-11-25,17,9,19,26
air_2fc478dc9f0a6b31,hpg_2d0a73d3f1cb646d,2016-11-26,20,6,20,26
air_2fc478dc9f0a6b31,hpg_2d0a73d3f1cb646d,2016-11-29,8,4,17,12
air_2fc478dc9f0a6b31,hpg_2d0a73d3f1cb646d,2016-12-02,16,11,20,27
air_2fc478dc9f0a6b31,hpg_2d0a73d3f1cb646d,2016-12-05,2,2,6,4
air_2fc478dc9f0a6b31,hpg_2d0a73d3f1cb646d,2016-12-08,6,3,6,9
air_2fc478dc9f0a6b31,hpg_2d0a73d3f1cb646d,2016-12-09,22,10,22,32
air_2fc478dc9f0a6b31,hpg_2d0a73d3f1cb646d,2016-12-10,23,13,23,36
air_2fc478dc9f0a6b31,hpg_2d0a73d3f1cb646d,2016-12-11,8,4,12,12
air_2fc478dc9f0a6b31,hpg_2d0a73d3f1cb646d,2016-12-14,11,4,18,15
air_2fc478dc9f0a6b31,hpg_2d0a73d3f1cb646d,2016-12-15,8,9,8,17
air_2fc478dc9f0a6b31,hpg_2d0a73d3f1cb646d,2016-12-16,22,17,22,39
air_2fc478dc9f0a6b31,hpg_2d0a73d3f1cb646d,2016-12-17,23,10,23,33
air_2fc478dc9f0a6b31,hpg_2d0a73d3f1cb646d,2016-12-18,9,4,11,13
air_2fc478dc9f0a6b31,hpg_2d0a73d3f1cb646d,2016-12-19,4,4,6,8
air_2fc478dc9f0a6b31,hpg_2d0a73d3f1cb646d,2016-12-20,3,3,13,6
air_2fc478dc9f0a6b31,hpg_2d0a73d3f1cb646d,2016-12-21,4,4,4,8
air_2fc478dc9f0a6b31,hpg_2d0a73d3f1cb646d,2016-12-22,23,13,27,36
air_2fc478dc9f0a6b31,hpg_2d0a73d3f1cb646d,2016-12-23,17,9,21,26
air_2fc478dc9f0a6b31,hpg_2d0a73d3f1cb646d,2016-12-24,18,14,24,32
air_2fc478dc9f0a6b31,hpg_2d0a73d3f1cb646d,2016-12-25,14,8,16,22
air_2fc478dc9f0a6b31,hpg_2d0a73d3f1cb646d,2016-12-26,15,4,17,19
air_2fc478dc9f0a6b31,hpg_2d0a73d3f1cb646d,2016-12-27,14,14,18,28
air_2fc478dc9f0a6b31,hpg_2d0a73d3f1cb646d,2016-12-28,21,7,15,28
air_2fc478dc9f0a6b31,hpg_2d0a73d3f1cb646d,2016-12-29,23,16,35,39
air_2fc478dc9f0a6b31,hpg_2d0a73d3f1cb646d,2016-12-30,18,11,28,29
air_2fc478dc9f0a6b31,hpg_2d0a73d3f1cb646d,2017-01-06,18,16,20,34
air_2fc478dc9f0a6b31,hpg_2d0a73d3f1cb646d,2017-01-07,10,8,14,18
air_2fc478dc9f0a6b31,hpg_2d0a73d3f1cb646d,2017-01-08,9,2,13,11
air_2fc478dc9f0a6b31,hpg_2d0a73d3f1cb646d,2017-01-12,5,3,5,8
air_2fc478dc9f0a6b31,hpg_2d0a73d3f1cb646d,2017-01-13,11,5,16,16
air_2fc478dc9f0a6b31,hpg_2d0a73d3f1cb646d,2017-01-14,12,2,19,14
air_2fc478dc9f0a6b31,hpg_2d0a73d3f1cb646d,2017-01-15,4,4,4,8
air_2fc478dc9f0a6b31,hpg_2d0a73d3f1cb646d,2017-01-17,2,2,11,4
air_2fc478dc9f0a6b31,hpg_2d0a73d3f1cb646d,2017-01-18,2,2,10,4
air_2fc478dc9f0a6b31,hpg_2d0a73d3f1cb646d,2017-01-19,7,4,7,11
air_2fc478dc9f0a6b31,hpg_2d0a73d3f1cb646d,2017-01-21,9,5,22,14
air_2fc478dc9f0a6b31,hpg_2d0a73d3f1cb646d,2017-01-22,15,3,5,18
air_2fc478dc9f0a6b31,hpg_2d0a73d3f1cb646d,2017-01-24,4,4,4,8
air_2fc478dc9f0a6b31,hpg_2d0a73d3f1cb646d,2017-01-27,26,13,33,39
air_2fc478dc9f0a6b31,hpg_2d0a73d3f1cb646d,2017-01-28,12,4,25,16
air_2fc478dc9f0a6b31,hpg_2d0a73d3f1cb646d,2017-02-02,4,4,8,8
air_2fc478dc9f0a6b31,hpg_2d0a73d3f1cb646d,2017-02-03,7,7,14,14
air_2fc478dc9f0a6b31,hpg_2d0a73d3f1cb646d,2017-02-04,16,10,21,26
air_2fc478dc9f0a6b31,hpg_2d0a73d3f1cb646d,2017-02-07,18,4,18,22
air_2fc478dc9f0a6b31,hpg_2d0a73d3f1cb646d,2017-02-10,22,12,30,34
air_2fc478dc9f0a6b31,hpg_2d0a73d3f1cb646d,2017-02-11,18,18,25,36
air_2fc478dc9f0a6b31,hpg_2d0a73d3f1cb646d,2017-02-12,4,2,6,6
air_2fc478dc9f0a6b31,hpg_2d0a73d3f1cb646d,2017-02-13,8,6,9,14
air_2fc478dc9f0a6b31,hpg_2d0a73d3f1cb646d,2017-02-14,6,4,15,10
air_2fc478dc9f0a6b31,hpg_2d0a73d3f1cb646d,2017-02-17,10,2,18,12
air_2fc478dc9f0a6b31,hpg_2d0a73d3f1cb646d,2017-02-18,16,6,20,22
air_2fc478dc9f0a6b31,hpg_2d0a73d3f1cb646d,2017-02-19,12,4,14,16
air_2fc478dc9f0a6b31,hpg_2d0a73d3f1cb646d,2017-02-20,2,2,2,4
air_2fc478dc9f0a6b31,hpg_2d0a73d3f1cb646d,2017-02-23,10,10,13,20
air_2fc478dc9f0a6b31,hpg_2d0a73d3f1cb646d,2017-02-24,22,18,22,40
air_2fc478dc9f0a6b31,hpg_2d0a73d3f1cb646d,2017-02-25,19,4,21,23
air_2fc478dc9f0a6b31,hpg_2d0a73d3f1cb646d,2017-02-26,9,6,16,15
air_2fc478dc9f0a6b31,hpg_2d0a73d3f1cb646d,2017-02-28,12,14,16,26
air_2fc478dc9f0a6b31,hpg_2d0a73d3f1cb646d,2017-03-02,7,7,12,14
air_2fc478dc9f0a6b31,hpg_2d0a73d3f1cb646d,2017-03-03,14,12,18,26
air_2fc478dc9f0a6b31,hpg_2d0a73d3f1cb646d,2017-03-04,7,7,13,14
air_2fc478dc9f0a6b31,hpg_2d0a73d3f1cb646d,2017-03-07,6,4,10,10
air_2fc478dc9f0a6b31,hpg_2d0a73d3f1cb646d,2017-03-09,5,5,11,10
air_2fc478dc9f0a6b31,hpg_2d0a73d3f1cb646d,2017-03-10,17,4,22,21
air_2fc478dc9f0a6b31,hpg_2d0a73d3f1cb646d,2017-03-11,10,4,16,14
air_2fc478dc9f0a6b31,hpg_2d0a73d3f1cb646d,2017-03-12,6,6,6,12
air_2fc478dc9f0a6b31,hpg_2d0a73d3f1cb646d,2017-03-13,7,5,10,12
air_2fc478dc9f0a6b31,hpg_2d0a73d3f1cb646d,2017-03-16,7,4,7,11
air_2fc478dc9f0a6b31,hpg_2d0a73d3f1cb646d,2017-03-17,13,9,17,22
air_2fc478dc9f0a6b31,hpg_2d0a73d3f1cb646d,2017-03-18,11,5,15,16
air_2fc478dc9f0a6b31,hpg_2d0a73d3f1cb646d,2017-03-19,13,5,19,18
air_2fc478dc9f0a6b31,hpg_2d0a73d3f1cb646d,2017-03-21,17,7,19,24
air_2fc478dc9f0a6b31,hpg_2d0a73d3f1cb646d,2017-03-24,22,18,22,40
air_2fc478dc9f0a6b31,hpg_2d0a73d3f1cb646d,2017-03-25,19,14,24,33
air_2fc478dc9f0a6b31,hpg_2d0a73d3f1cb646d,2017-03-27,8,8,15,16
air_2fc478dc9f0a6b31,hpg_2d0a73d3f1cb646d,2017-03-28,19,2,19,21
air_2fc478dc9f0a6b31,hpg_2d0a73d3f1cb646d,2017-03-30,4,2,6,6
air_2fc478dc9f0a6b31,hpg_2d0a73d3f1cb646d,2017-03-31,4,4,9,8
air_2fc478dc9f0a6b31,hpg_2d0a73d3f1cb646d,2017-04-01,16,6,24,22
air_2fc478dc9f0a6b31,hpg_2d0a73d3f1cb646d,2017-04-03,7,2,9,9
air_2fc478dc9f0a6b31,hpg_2d0a73d3f1cb646d,2017-04-06,2,2,5,4
air_2fc478dc9f0a6b31,hpg_2d0a73d3f1cb646d,2017-04-07,13,3,17,16
air_2fc478dc9f0a6b31,hpg_2d0a73d3f1cb646d,2017-04-08,12,2,16,14
air_2fc478dc9f0a6b31,hpg_2d0a73d3f1cb646d,2017-04-11,4,2,4,6
air_2fc478dc9f0a6b31,hpg_2d0a73d3f1cb646d,2017-04-14,17,8,17,25
air_2fc478dc9f0a6b31,hpg_2d0a73d3f1cb646d,2017-04-15,20,7,21,27
air_2fc478dc9f0a6b31,hpg_2d0a73d3f1cb646d,2017-04-16,6,8,11,14
air_2fc478dc9f0a6b31,hpg_2d0a73d3f1cb646d,2017-04-18,2,2,2,4
air_2fc478dc9f0a6b31,hpg_2d0a73d3f1cb646d,2017-04-20,10,8,12,18
air_2fc478dc9f0a6b31,hpg_2d0a73d3f1cb646d,2017-04-21,19,5,19,24
air_2fc478dc9f0a6b31,hpg_2d0a73d3f1cb646d,2017-04-22,13,9,17,22
air_42d41eb58cad170e,hpg_70f700e5a6148b7e,2016-10-29,17,6,43,23
air_42d41eb58cad170e,hpg_70f700e5a6148b7e,2016-10-30,5,2,40,7
air_42d41eb58cad170e,hpg_70f700e5a6148b7e,2016-11-02,8,3,16,11
air_42d41eb58cad170e,hpg_70f700e5a6148b7e,2016-11-03,3,3,25,6
air_42d41eb58cad170e,hpg_70f700e5a6148b7e,2016-11-07,4,4,18,8
air_42d41eb58cad170e,hpg_70f700e5a6148b7e,2016-11-11,3,10,18,13
air_42d41eb58cad170e,hpg_70f700e5a6148b7e,2016-11-12,7,7,36,14
air_42d41eb58cad170e,hpg_70f700e5a6148b7e,2016-11-18,3,3,8,6
air_42d41eb58cad170e,hpg_70f700e5a6148b7e,2016-11-19,9,6,40,15
air_42d41eb58cad170e,hpg_70f700e5a6148b7e,2016-11-20,4,4,43,8
air_42d41eb58cad170e,hpg_70f700e5a6148b7e,2016-11-26,5,3,51,8
air_42d41eb58cad170e,hpg_70f700e5a6148b7e,2016-11-28,6,3,19,9
air_42d41eb58cad170e,hpg_70f700e5a6148b7e,2016-12-02,3,3,23,6
air_42d41eb58cad170e,hpg_70f700e5a6148b7e,2016-12-07,13,8,50,21
air_42d41eb58cad170e,hpg_70f700e5a6148b7e,2016-12-16,18,2,41,20
air_42d41eb58cad170e,hpg_70f700e5a6148b7e,2016-12-24,11,2,39,13
air_42d41eb58cad170e,hpg_70f700e5a6148b7e,2017-01-03,7,5,71,12
air_42d41eb58cad170e,hpg_70f700e5a6148b7e,2017-01-06,2,2,24,4
air_42d41eb58cad170e,hpg_70f700e5a6148b7e,2017-01-17,4,8,8,12
air_42d41eb58cad170e,hpg_70f700e5a6148b7e,2017-01-19,9,4,9,13
air_42d41eb58cad170e,hpg_70f700e5a6148b7e,2017-01-30,2,2,12,4
air_42d41eb58cad170e,hpg_70f700e5a6148b7e,2017-01-31,3,3,15,6
air_42d41eb58cad170e,hpg_70f700e5a6148b7e,2017-02-06,3,3,23,6
air_42d41eb58cad170e,hpg_70f700e5a6148b7e,2017-02-11,22,15,33,37
air_42d41eb58cad170e,hpg_70f700e5a6148b7e,2017-02-17,7,4,13,11
air_42d41eb58cad170e,hpg_70f700e5a6148b7e,2017-02-21,6,6,17,12
air_42d41eb58cad170e,hpg_70f700e5a6148b7e,2017-02-24,7,3,19,10
air_42d41eb58cad170e,hpg_70f700e5a6148b7e,2017-02-25,8,2,53,10
air_42d41eb58cad170e,hpg_70f700e5a6148b7e,2017-03-03,6,3,30,9
air_42d41eb58cad170e,hpg_70f700e5a6148b7e,2017-03-31,7,7,36,14
air_42d41eb58cad170e,hpg_70f700e5a6148b7e,2017-04-01,2,2,18,4
air_42d41eb58cad170e,hpg_70f700e5a6148b7e,2017-04-07,11,8,35,19
air_42d41eb58cad170e,hpg_70f700e5a6148b7e,2017-04-09,23,9,31,32
air_42d41eb58cad170e,hpg_70f700e5a6148b7e,2017-04-10,10,4,23,14
air_42d41eb58cad170e,hpg_70f700e5a6148b7e,2017-04-11,9,9,13,18
air_5a9a6cbeeb434c08,hpg_cad1acd4374ceaa1,2016-10-28,7,7,66,14
air_5a9a6cbeeb434c08,hpg_cad1acd4374ceaa1,2016-10-29,15,3,23,18
air_5a9a6cbeeb434c08,hpg_cad1acd4374ceaa1,2016-10-31,43,2,26,45
air_5a9a6cbeeb434c08,hpg_cad1acd4374ceaa1,2016-11-14,17,17,28,34
air_5a9a6cbeeb434c08,hpg_cad1acd4374ceaa1,2016-11-24,17,3,30,20
air_5a9a6cbeeb434c08,hpg_cad1acd4374ceaa1,2016-11-26,15,8,18,23
air_5a9a6cbeeb434c08,hpg_cad1acd4374ceaa1,2016-11-29,10,10,15,20
air_5a9a6cbeeb434c08,hpg_cad1acd4374ceaa1,2016-11-30,7,2,20,9
air_5a9a6cbeeb434c08,hpg_cad1acd4374ceaa1,2016-12-01,2,2,18,4
air_5a9a6cbeeb434c08,hpg_cad1acd4374ceaa1,2016-12-02,9,51,26,60
air_5a9a6cbeeb434c08,hpg_cad1acd4374ceaa1,2016-12-06,2,2,10,4
air_5a9a6cbeeb434c08,hpg_cad1acd4374ceaa1,2016-12-07,21,6,30,27
air_5a9a6cbeeb434c08,hpg_cad1acd4374ceaa1,2016-12-09,25,5,27,30
air_5a9a6cbeeb434c08,hpg_cad1acd4374ceaa1,2016-12-10,2,2,20,4
air_5a9a6cbeeb434c08,hpg_cad1acd4374ceaa1,2016-12-15,3,3,14,6
air_5a9a6cbeeb434c08,hpg_cad1acd4374ceaa1,2016-12-17,35,8,54,43
air_5a9a6cbeeb434c08,hpg_cad1acd4374ceaa1,2016-12-20,21,3,28,24
air_5a9a6cbeeb434c08,hpg_cad1acd4374ceaa1,2016-12-21,7,3,18,10
air_5a9a6cbeeb434c08,hpg_cad1acd4374ceaa1,2016-12-22,7,18,19,25
air_5a9a6cbeeb434c08,hpg_cad1acd4374ceaa1,2016-12-23,3,3,37,6
air_5a9a6cbeeb434c08,hpg_cad1acd4374ceaa1,2016-12-26,3,3,14,6
air_5a9a6cbeeb434c08,hpg_cad1acd4374ceaa1,2016-12-28,34,4,47,38
air_5a9a6cbeeb434c08,hpg_cad1acd4374ceaa1,2016-12-30,5,5,37,10
air_5a9a6cbeeb434c08,hpg_cad1acd4374ceaa1,2017-01-06,3,3,18,6
air_5a9a6cbeeb434c08,hpg_cad1acd4374ceaa1,2017-01-08,6,8,20,14
air_5a9a6cbeeb434c08,hpg_cad1acd4374ceaa1,2017-01-12,3,3,22,6
air_5a9a6cbeeb434c08,hpg_cad1acd4374ceaa1,2017-01-17,10,7,9,17
air_5a9a6cbeeb434c08,hpg_cad1acd4374ceaa1,2017-01-18,25,25,46,50
air_5a9a6cbeeb434c08,hpg_cad1acd4374ceaa1,2017-01-19,6,3,12,9
air_5a9a6cbeeb434c08,hpg_cad1acd4374ceaa1,2017-01-23,11,2,10,13
air_5a9a6cbeeb434c08,hpg_cad1acd4374ceaa1,2017-01-25,10,10,17,20
air_5a9a6cbeeb434c08,hpg_cad1acd4374ceaa1,2017-01-26,12,12,5,24
air_5a9a6cbeeb434c08,hpg_cad1acd4374ceaa1,2017-01-27,20,7,46,27
air_5a9a6cbeeb434c08,hpg_cad1acd4374ceaa1,2017-01-28,2,2,21,4
air_5a9a6cbeeb434c08,hpg_cad1acd4374ceaa1,2017-02-09,3,3,8,6
air_5a9a6cbeeb434c08,hpg_cad1acd4374ceaa1,2017-02-10,30,2,50,32
air_5a9a6cbeeb434c08,hpg_cad1acd4374ceaa1,2017-02-11,18,5,24,23
air_5a9a6cbeeb434c08,hpg_cad1acd4374ceaa1,2017-02-13,3,3,15,6
air_5a9a6cbeeb434c08,hpg_cad1acd4374ceaa1,2017-02-15,9,9,13,18
air_5a9a6cbeeb434c08,hpg_cad1acd4374ceaa1,2017-02-17,16,4,35,20
air_5a9a6cbeeb434c08,hpg_cad1acd4374ceaa1,2017-02-24,11,3,27,14
air_5a9a6cbeeb434c08,hpg_cad1acd4374ceaa1,2017-03-02,14,26,44,40
air_5a9a6cbeeb434c08,hpg_cad1acd4374ceaa1,2017-03-03,23,2,27,25
air_5a9a6cbeeb434c08,hpg_cad1acd4374ceaa1,2017-03-09,13,5,8,18
air_5a9a6cbeeb434c08,hpg_cad1acd4374ceaa1,2017-03-11,19,16,42,35
air_5a9a6cbeeb434c08,hpg_cad1acd4374ceaa1,2017-03-15,16,16,32,32
air_5a9a6cbeeb434c08,hpg_cad1acd4374ceaa1,2017-03-27,3,40,16,43
air_5a9a6cbeeb434c08,hpg_cad1acd4374ceaa1,2017-03-29,28,14,46,42
air_5a9a6cbeeb434c08,hpg_cad1acd4374ceaa1,2017-04-03,31,2,33,33
air_5a9a6cbeeb434c08,hpg_cad1acd4374ceaa1,2017-04-04,7,7,40,14
air_5a9a6cbeeb434c08,hpg_cad1acd4374ceaa1,2017-04-06,21,3,24,24
air_5a9a6cbeeb434c08,hpg_cad1acd4374ceaa1,2017-04-08,5,5,18,10
air_5a9a6cbeeb434c08,hpg_cad1acd4374ceaa1,2017-04-13,14,5,35,19
air_5a9a6cbeeb434c08,hpg_cad1acd4374ceaa1,2017-04-14,22,4,48,26
air_5a9a6cbeeb434c08,hpg_cad1acd4374ceaa1,2017-04-17,13,9,21,22
air_5a9a6cbeeb434c08,hpg_cad1acd4374ceaa1,2017-04-18,17,2,19,19
air_5a9a6cbeeb434c08,hpg_cad1acd4374ceaa1,2017-04-21,32,4,46,36
air_5a9a6cbeeb434c08,hpg_cad1acd4374ceaa1,2017-04-22,5,5,40,10
air_640cf4835f0d9ba3,hpg_e63863c8987bd064,2016-11-04,27,3,37,30
air_640cf4835f0d9ba3,hpg_e63863c8987bd064,2016-12-10,12,9,41,21
air_640cf4835f0d9ba3,hpg_e63863c8987bd064,2016-12-16,48,16,59,64
air_640cf4835f0d9ba3,hpg_e63863c8987bd064,2016-12-18,30,63,37,93
air_640cf4835f0d9ba3,hpg_e63863c8987bd064,2016-12-21,49,26,49,75
air_640cf4835f0d9ba3,hpg_e63863c8987bd064,2016-12-22,20,24,69,44
air_640cf4835f0d9ba3,hpg_e63863c8987bd064,2016-12-26,11,2,21,13
air_640cf4835f0d9ba3,hpg_e63863c8987bd064,2016-12-27,30,15,54,45
air_640cf4835f0d9ba3,hpg_e63863c8987bd064,2017-02-25,23,2,37,25
air_640cf4835f0d9ba3,hpg_e63863c8987bd064,2017-03-10,8,3,43,11
air_640cf4835f0d9ba3,hpg_e63863c8987bd064,2017-03-29,7,20,17,27
air_640cf4835f0d9ba3,hpg_e63863c8987bd064,2017-04-07,34,25,68,59
air_1d1e8860ae04f8e9,hpg_2fcae64da5287bf5,2016-11-09,2,2,6,4
air_1d1e8860ae04f8e9,hpg_2fcae64da5287bf5,2016-12-26,4,2,4,6
air_754ae581ad80cc9f,hpg_625efd16f722d4f4,2016-10-29,3,3,11,6
air_754ae581ad80cc9f,hpg_625efd16f722d4f4,2016-10-30,4,4,12,8
air_754ae581ad80cc9f,hpg_625efd16f722d4f4,2016-10-31,10,7,11,17
air_754ae581ad80cc9f,hpg_625efd16f722d4f4,2016-11-10,8,8,16,16
air_754ae581ad80cc9f,hpg_625efd16f722d4f4,2016-11-11,17,8,14,25
air_754ae581ad80cc9f,hpg_625efd16f722d4f4,2016-11-12,26,4,28,30
air_754ae581ad80cc9f,hpg_625efd16f722d4f4,2016-11-20,9,9,21,18
air_754ae581ad80cc9f,hpg_625efd16f722d4f4,2016-11-22,7,7,8,14
air_754ae581ad80cc9f,hpg_625efd16f722d4f4,2016-11-24,2,2,16,4
air_754ae581ad80cc9f,hpg_625efd16f722d4f4,2016-11-26,36,11,38,47
air_754ae581ad80cc9f,hpg_625efd16f722d4f4,2016-11-27,9,9,16,18
air_754ae581ad80cc9f,hpg_625efd16f722d4f4,2016-11-28,14,11,23,25
air_754ae581ad80cc9f,hpg_625efd16f722d4f4,2016-11-30,6,3,8,9
air_754ae581ad80cc9f,hpg_625efd16f722d4f4,2016-12-10,15,3,27,18
air_754ae581ad80cc9f,hpg_625efd16f722d4f4,2016-12-12,22,2,28,24
air_754ae581ad80cc9f,hpg_625efd16f722d4f4,2016-12-16,17,17,25,34
air_754ae581ad80cc9f,hpg_625efd16f722d4f4,2016-12-17,3,6,12,9
air_754ae581ad80cc9f,hpg_625efd16f722d4f4,2016-12-18,15,12,17,27
air_754ae581ad80cc9f,hpg_625efd16f722d4f4,2016-12-21,20,17,28,37
air_754ae581ad80cc9f,hpg_625efd16f722d4f4,2016-12-22,4,4,8,8
air_754ae581ad80cc9f,hpg_625efd16f722d4f4,2016-12-23,17,7,29,24
air_754ae581ad80cc9f,hpg_625efd16f722d4f4,2016-12-24,33,12,41,45
air_754ae581ad80cc9f,hpg_625efd16f722d4f4,2016-12-28,2,2,16,4
air_754ae581ad80cc9f,hpg_625efd16f722d4f4,2017-01-07,7,4,7,11
air_754ae581ad80cc9f,hpg_625efd16f722d4f4,2017-01-18,2,2,2,4
air_754ae581ad80cc9f,hpg_625efd16f722d4f4,2017-01-21,12,18,30,30
air_754ae581ad80cc9f,hpg_625efd16f722d4f4,2017-01-23,7,7,7,14
air_754ae581ad80cc9f,hpg_625efd16f722d4f4,2017-01-30,8,8,8,16
air_754ae581ad80cc9f,hpg_625efd16f722d4f4,2017-02-04,9,2,16,11
air_754ae581ad80cc9f,hpg_625efd16f722d4f4,2017-02-09,3,3,10,6
air_754ae581ad80cc9f,hpg_625efd16f722d4f4,2017-02-10,3,3,12,6
air_754ae581ad80cc9f,hpg_625efd16f722d4f4,2017-02-13,10,10,22,20
air_754ae581ad80cc9f,hpg_625efd16f722d4f4,2017-02-15,20,5,24,25
air_754ae581ad80cc9f,hpg_625efd16f722d4f4,2017-02-16,16,13,36,29
air_754ae581ad80cc9f,hpg_625efd16f722d4f4,2017-02-17,8,8,13,16
air_754ae581ad80cc9f,hpg_625efd16f722d4f4,2017-02-18,11,2,32,13
air_754ae581ad80cc9f,hpg_625efd16f722d4f4,2017-02-19,18,6,32,24
air_754ae581ad80cc9f,hpg_625efd16f722d4f4,2017-02-27,4,4,20,8
air_754ae581ad80cc9f,hpg_625efd16f722d4f4,2017-03-02,11,11,1,22
air_754ae581ad80cc9f,hpg_625efd16f722d4f4,2017-03-03,22,17,35,39
air_754ae581ad80cc9f,hpg_625efd16f722d4f4,2017-03-04,5,5,15,10
air_754ae581ad80cc9f,hpg_625efd16f722d4f4,2017-03-09,6,6,10,12
air_754ae581ad80cc9f,hpg_625efd16f722d4f4,2017-03-11,20,3,25,23
air_754ae581ad80cc9f,hpg_625efd16f722d4f4,2017-03-13,3,3,6,6
air_754ae581ad80cc9f,hpg_625efd16f722d4f4,2017-03-18,31,4,39,35
air_754ae581ad80cc9f,hpg_625efd16f722d4f4,2017-03-25,32,21,54,53
air_754ae581ad80cc9f,hpg_625efd16f722d4f4,2017-03-29,18,18,18,36
air_754ae581ad80cc9f,hpg_625efd16f722d4f4,2017-04-06,27,27,28,54
air_754ae581ad80cc9f,hpg_625efd16f722d4f4,2017-04-08,38,24,42,62
air_754ae581ad80cc9f,hpg_625efd16f722d4f4,2017-04-14,2,2,3,4
air_754ae581ad80cc9f,hpg_625efd16f722d4f4,2017-04-15,20,20,39,40
air_754ae581ad80cc9f,hpg_625efd16f722d4f4,2017-04-19,6,6,6,12
